pnum,year,timedate,date,time_min,sunrise,sunrise_min,diff_time
20211O58,2021,2021-04-16 04:38:48.173333,2021-04-16,278,2021-04-16 05:06:57.881000+00:00,306,-28
20211O58,2021,2021-04-17 04:43:26.272000,2021-04-17,283,2021-04-17 05:04:49.003674+00:00,304,-21
20211O58,2021,2021-04-18 04:47:12.246667,2021-04-18,287,2021-04-18 05:02:40.924716+00:00,302,-15
20211O60,2021,2021-04-21 04:19:01.416000,2021-04-21,259,2021-04-21 04:56:21.847588+00:00,296,-37
20211O60,2021,2021-04-22 04:19:23.050667,2021-04-22,259,2021-04-22 04:54:17.334440+00:00,294,-35
20211O66,2021,2021-04-15 04:37:21.269333,2021-04-15,277,2021-04-15 05:09:07.520545+00:00,309,-32
20211O7,2021,2021-04-22 04:18:00.400000,2021-04-22,258,2021-04-22 04:54:17.334440+00:00,294,-36
20211O7,2021,2021-04-23 04:19:18.304000,2021-04-23,259,2021-04-23 04:52:13.808673+00:00,292,-33
20211O7,2021,2021-04-24 04:15:23.589333,2021-04-24,255,2021-04-24 04:50:11.309838+00:00,290,-35
20211O75B,2021,2021-04-29 04:16:08.016000,2021-04-29,256,2021-04-29 04:40:15.646887+00:00,280,-24
20211O75C,2021,2021-04-25 04:28:08.096000,2021-04-25,268,2021-04-25 04:48:09.878095+00:00,288,-20
20211O75C,2021,2021-04-26 04:29:18.372000,2021-04-26,269,2021-04-26 04:46:09.554219+00:00,286,-17
20211O75C,2021,2021-04-27 04:37:42.560000,2021-04-27,277,2021-04-27 04:44:10.379607+00:00,284,-7
20211O75D,2021,2021-04-17 04:39:16.890667,2021-04-17,279,2021-04-17 05:04:49.003674+00:00,304,-25
20211O75D,2021,2021-04-18 04:28:03.242667,2021-04-18,268,2021-04-18 05:02:40.924716+00:00,302,-34
20211O76,2021,2021-04-28 04:27:34.453333,2021-04-28,267,2021-04-28 04:42:12.396280+00:00,282,-15
20211O76,2021,2021-04-29 04:18:01.957333,2021-04-29,258,2021-04-29 04:40:15.646887+00:00,280,-22
20211O76,2021,2021-04-30 04:09:26.144000,2021-04-30,249,2021-04-30 04:38:20.174704+00:00,278,-29
20211O77,2021,2021-04-19 04:32:36.864000,2021-04-19,272,2021-04-19 05:00:33.680803+00:00,300,-28
20211O77,2021,2021-04-20 04:33:18.688000,2021-04-20,273,2021-04-20 04:58:27.309164+00:00,298,-25
20211O77,2021,2021-04-21 04:27:40.752000,2021-04-21,267,2021-04-21 04:56:21.847588+00:00,296,-29
20211O83,2021,2021-04-20 04:30:12.706667,2021-04-20,270,2021-04-20 04:58:27.309164+00:00,298,-28
20211O83,2021,2021-04-21 04:22:43.980000,2021-04-21,262,2021-04-21 04:56:21.847588+00:00,296,-34
20211CP40A,2021,2021-04-07 04:55:12.533333,2021-04-07,295,2021-04-07 05:26:47.900370+00:00,326,-31
20211CP40A,2021,2021-04-08 04:54:11.829000,2021-04-08,294,2021-04-08 05:24:33.406551+00:00,324,-30
20211CP40A,2021,2021-04-09 04:52:56.876000,2021-04-09,292,2021-04-09 05:22:19.402706+00:00,322,-30
20211CP40A,2021,2021-04-10 04:57:21.340000,2021-04-10,297,2021-04-10 05:20:05.921408+00:00,320,-23
20211CP40A,2021,2021-04-11 04:52:38.292000,2021-04-11,292,2021-04-11 05:17:52.995603+00:00,317,-25
20211CP40A,2021,2021-04-12 04:50:45.672000,2021-04-12,290,2021-04-12 05:15:40.658633+00:00,315,-25
20211CP5A,2021,2021-04-24 04:43:30.766667,2021-04-24,283,2021-04-24 04:50:11.309838+00:00,290,-7
20211CP5A,2021,2021-04-25 04:48:05.072000,2021-04-25,288,2021-04-25 04:48:09.878095+00:00,288,0
20211EX13A,2021,2021-04-20 04:28:33.312000,2021-04-20,268,2021-04-20 04:58:27.309164+00:00,298,-30
20211EX13A,2021,2021-04-22 04:25:06.526667,2021-04-22,265,2021-04-22 04:54:17.334440+00:00,294,-29
20211EX14,2021,2021-04-20 04:29:14.586667,2021-04-20,269,2021-04-20 04:58:27.309164+00:00,298,-29
20211EX14,2021,2021-04-21 04:26:56.542667,2021-04-21,266,2021-04-21 04:56:21.847588+00:00,296,-30
20211EX14,2021,2021-04-22 04:24:37.546667,2021-04-22,264,2021-04-22 04:54:17.334440+00:00,294,-30
20211EX18A,2021,2021-04-14 04:57:36.256000,2021-04-14,297,2021-04-14 05:11:17.886676+00:00,311,-14
20211EX18A,2021,2021-04-15 04:48:34.584000,2021-04-15,288,2021-04-15 05:09:07.520545+00:00,309,-21
20211EX18A,2021,2021-04-16 04:42:10.848000,2021-04-16,282,2021-04-16 05:06:57.881000+00:00,306,-24
20211EX2,2021,2021-04-20 04:42:34.617333,2021-04-20,282,2021-04-20 04:58:27.309164+00:00,298,-16
20211EX25,2021,2021-04-20 04:33:55.488000,2021-04-20,273,2021-04-20 04:58:27.309164+00:00,298,-25
20211EX25,2021,2021-04-22 04:30:52.726667,2021-04-22,270,2021-04-22 04:54:17.334440+00:00,294,-24
20211EX38A,2021,2021-04-20 04:35:49.410667,2021-04-20,275,2021-04-20 04:58:27.309164+00:00,298,-23
20211EX38A,2021,2021-04-21 04:44:31.584000,2021-04-21,284,2021-04-21 04:56:21.847588+00:00,296,-12
20211EX38A,2021,2021-04-22 04:33:00.656000,2021-04-22,273,2021-04-22 04:54:17.334440+00:00,294,-21
20211EX41A,2021,2021-04-20 04:37:05.568000,2021-04-20,277,2021-04-20 04:58:27.309164+00:00,298,-21
20211EX41A,2021,2021-04-21 04:35:06.000000,2021-04-21,275,2021-04-21 04:56:21.847588+00:00,296,-21
20211EX41A,2021,2021-04-22 04:28:21.504000,2021-04-22,268,2021-04-22 04:54:17.334440+00:00,294,-26
20211EX43C,2021,2021-04-30 04:55:31.466667,2021-04-30,295,2021-04-30 04:38:20.174704+00:00,278,17
20211EX47,2021,2021-04-15 04:38:13.696000,2021-04-15,278,2021-04-15 05:09:07.520545+00:00,309,-31
20211EX47,2021,2021-04-16 04:37:35.530667,2021-04-16,277,2021-04-16 05:06:57.881000+00:00,306,-29
20211EX47,2021,2021-04-17 04:47:19.760000,2021-04-17,287,2021-04-17 05:04:49.003674+00:00,304,-17
20211EX49A,2021,2021-04-27 04:20:23.626667,2021-04-27,260,2021-04-27 04:44:10.379607+00:00,284,-24
20211EX51,2021,2021-04-23 04:28:17.136000,2021-04-23,268,2021-04-23 04:52:13.808673+00:00,292,-24
20211EX51,2021,2021-04-24 04:32:31.146667,2021-04-24,272,2021-04-24 04:50:11.309838+00:00,290,-18
20211EX51,2021,2021-04-25 04:21:13.056000,2021-04-25,261,2021-04-25 04:48:09.878095+00:00,288,-27
20211EX55,2021,2021-04-15 04:36:39.168000,2021-04-15,276,2021-04-15 05:09:07.520545+00:00,309,-33
20211EX55,2021,2021-04-16 04:31:57.824000,2021-04-16,271,2021-04-16 05:06:57.881000+00:00,306,-35
20211EX55,2021,2021-04-17 04:31:33.120000,2021-04-17,271,2021-04-17 05:04:49.003674+00:00,304,-33
20211EX57,2021,2021-04-15 05:15:52.578667,2021-04-15,315,2021-04-15 05:09:07.520545+00:00,309,6
20211EX57,2021,2021-04-21 04:29:55.786667,2021-04-21,269,2021-04-21 04:56:21.847588+00:00,296,-27
20211EX5A,2021,2021-04-15 04:29:17.352000,2021-04-15,269,2021-04-15 05:09:07.520545+00:00,309,-40
20211EX60,2021,2021-04-21 04:26:58.776000,2021-04-21,266,2021-04-21 04:56:21.847588+00:00,296,-30
20211EX60,2021,2021-04-22 04:27:48.768000,2021-04-22,267,2021-04-22 04:54:17.334440+00:00,294,-27
20211EX60,2021,2021-04-23 04:23:06.213333,2021-04-23,263,2021-04-23 04:52:13.808673+00:00,292,-29
20211EX62,2021,2021-04-24 04:26:30.636000,2021-04-24,266,2021-04-24 04:50:11.309838+00:00,290,-24
20211EX62,2021,2021-04-25 04:24:38.048000,2021-04-25,264,2021-04-25 04:48:09.878095+00:00,288,-24
20211EX62C,2021,2021-04-28 04:19:20.364000,2021-04-28,259,2021-04-28 04:42:12.396280+00:00,282,-23
20211EX62C,2021,2021-04-29 04:14:36.288000,2021-04-29,254,2021-04-29 04:40:15.646887+00:00,280,-26
20211EX62C,2021,2021-04-30 04:16:45.312000,2021-04-30,256,2021-04-30 04:38:20.174704+00:00,278,-22
20211EX62C,2021,2021-05-01 04:13:00.714667,2021-05-01,253,2021-05-01 04:36:26.023634+00:00,276,-23
20211P6,2021,2021-04-20 04:33:40.466667,2021-04-20,273,2021-04-20 04:58:27.309164+00:00,298,-25
20211P6,2021,2021-04-21 04:32:34.080000,2021-04-21,272,2021-04-21 04:56:21.847588+00:00,296,-24
20211P6,2021,2021-04-22 04:27:30.282667,2021-04-22,267,2021-04-22 04:54:17.334440+00:00,294,-27
20211SW102,2021,2021-04-25 04:12:58.533333,2021-04-25,252,2021-04-25 04:48:09.878095+00:00,288,-36
20211SW102,2021,2021-04-26 04:10:51.456000,2021-04-26,250,2021-04-26 04:46:09.554219+00:00,286,-36
20211SW102,2021,2021-04-27 04:15:15.114667,2021-04-27,255,2021-04-27 04:44:10.379607+00:00,284,-29
20211SW102,2021,2021-04-29 04:16:55.066667,2021-04-29,256,2021-04-29 04:40:15.646887+00:00,280,-24
20211SW107,2021,2021-04-27 04:21:58.741333,2021-04-27,261,2021-04-27 04:44:10.379607+00:00,284,-23
20211SW107,2021,2021-04-29 04:24:26.832000,2021-04-29,264,2021-04-29 04:40:15.646887+00:00,280,-16
20211SW114,2021,2021-04-07 04:58:21.973333,2021-04-07,298,2021-04-07 05:26:47.900370+00:00,326,-28
20211SW114,2021,2021-04-08 04:57:28.016000,2021-04-08,297,2021-04-08 05:24:33.406551+00:00,324,-27
20211SW114,2021,2021-04-09 04:51:06.432000,2021-04-09,291,2021-04-09 05:22:19.402706+00:00,322,-31
20211SW119,2021,2021-04-25 04:12:34.357333,2021-04-25,252,2021-04-25 04:48:09.878095+00:00,288,-36
20211SW119,2021,2021-04-26 04:15:13.773333,2021-04-26,255,2021-04-26 04:46:09.554219+00:00,286,-31
20211SW119,2021,2021-04-27 04:07:36.133333,2021-04-27,247,2021-04-27 04:44:10.379607+00:00,284,-37
20211SW121,2021,2021-04-13 04:44:19.280000,2021-04-13,284,2021-04-13 05:13:28.944258+00:00,313,-29
20211SW121,2021,2021-04-14 04:43:00.384000,2021-04-14,283,2021-04-14 05:11:17.886676+00:00,311,-28
20211SW121,2021,2021-04-15 04:37:18.042000,2021-04-15,277,2021-04-15 05:09:07.520545+00:00,309,-32
20211SW121,2021,2021-04-16 04:35:04.560000,2021-04-16,275,2021-04-16 05:06:57.881000+00:00,306,-31
20211SW121,2021,2021-04-17 04:34:29.000000,2021-04-17,274,2021-04-17 05:04:49.003674+00:00,304,-30
20211SW121,2021,2021-04-18 04:29:12.538667,2021-04-18,269,2021-04-18 05:02:40.924716+00:00,302,-33
20211EX62E,2021,2021-04-25 04:05:19.704000,2021-04-25,245,2021-04-25 04:48:09.878095+00:00,288,-43
20211EX62E,2021,2021-04-26 04:06:56.426667,2021-04-26,246,2021-04-26 04:46:09.554219+00:00,286,-40
20211EX62E,2021,2021-04-27 04:08:01.264000,2021-04-27,248,2021-04-27 04:44:10.379607+00:00,284,-36
20211W28,2021,2021-04-21 04:23:12.810000,2021-04-21,263,2021-04-21 04:56:21.847588+00:00,296,-33
20211W28,2021,2021-04-22 04:23:13.806667,2021-04-22,263,2021-04-22 04:54:17.334440+00:00,294,-31
20211W28,2021,2021-04-23 04:25:23.872000,2021-04-23,265,2021-04-23 04:52:13.808673+00:00,292,-27
20211W69,2021,2021-04-09 04:50:43.818667,2021-04-09,290,2021-04-09 05:22:19.402706+00:00,322,-32
20211W69,2021,2021-04-14 04:37:10.920000,2021-04-14,277,2021-04-14 05:11:17.886676+00:00,311,-34
20211CP13,2021,2021-04-14 04:47:42.992000,2021-04-14,287,2021-04-14 05:11:17.886676+00:00,311,-24
20211CP13,2021,2021-04-18 04:31:47.080000,2021-04-18,271,2021-04-18 05:02:40.924716+00:00,302,-31
20211CP13,2021,2021-04-19 04:22:40.048000,2021-04-19,262,2021-04-19 05:00:33.680803+00:00,300,-38
20211CP13,2021,2021-04-20 04:25:22.108000,2021-04-20,265,2021-04-20 04:58:27.309164+00:00,298,-33
20211CP18,2021,2021-04-21 04:32:29.720000,2021-04-21,272,2021-04-21 04:56:21.847588+00:00,296,-24
20211CP18,2021,2021-04-22 04:41:56.322667,2021-04-22,281,2021-04-22 04:54:17.334440+00:00,294,-13
20211CP20,2021,2021-04-13 04:46:19.152000,2021-04-13,286,2021-04-13 05:13:28.944258+00:00,313,-27
20211CP20,2021,2021-04-14 04:47:34.646667,2021-04-14,287,2021-04-14 05:11:17.886676+00:00,311,-24
20211CP20,2021,2021-04-15 04:44:08.734667,2021-04-15,284,2021-04-15 05:09:07.520545+00:00,309,-25
20211CP20,2021,2021-04-17 04:37:58.630667,2021-04-17,277,2021-04-17 05:04:49.003674+00:00,304,-27
20211CP28,2021,2021-04-23 04:19:09.936000,2021-04-23,259,2021-04-23 04:52:13.808673+00:00,292,-33
20211CP28,2021,2021-04-24 04:21:27.288000,2021-04-24,261,2021-04-24 04:50:11.309838+00:00,290,-29
20211CP28,2021,2021-04-25 04:16:19.197333,2021-04-25,256,2021-04-25 04:48:09.878095+00:00,288,-32
20211CP30,2021,2021-04-18 04:27:35.056000,2021-04-18,267,2021-04-18 05:02:40.924716+00:00,302,-35
20211CP30,2021,2021-04-19 04:32:23.144000,2021-04-19,272,2021-04-19 05:00:33.680803+00:00,300,-28
20211MP71,2021,2021-04-08 04:53:23.040000,2021-04-08,293,2021-04-08 05:24:33.406551+00:00,324,-31
20211MP71,2021,2021-04-09 04:49:20.328000,2021-04-09,289,2021-04-09 05:22:19.402706+00:00,322,-33
20211MP71,2021,2021-04-11 04:52:53.088000,2021-04-11,292,2021-04-11 05:17:52.995603+00:00,317,-25
20211MP71,2021,2021-04-12 04:48:17.888000,2021-04-12,288,2021-04-12 05:15:40.658633+00:00,315,-27
20211MP71,2021,2021-04-13 04:43:20.064000,2021-04-13,283,2021-04-13 05:13:28.944258+00:00,313,-30
20211MP72,2021,2021-05-06 04:06:38.677333,2021-05-06,246,2021-05-06 04:27:16.664342+00:00,267,-21
20211MP72,2021,2021-05-07 04:22:22.848000,2021-05-07,262,2021-05-07 04:25:31.395851+00:00,265,-3
20211MP73,2021,2021-04-17 04:32:15.552000,2021-04-17,272,2021-04-17 05:04:49.003674+00:00,304,-32
20211MP73,2021,2021-04-18 04:34:39.200000,2021-04-18,274,2021-04-18 05:02:40.924716+00:00,302,-28
20211MP73,2021,2021-04-19 04:29:46.240000,2021-04-19,269,2021-04-19 05:00:33.680803+00:00,300,-31
20211MP76,2021,2021-04-01 05:14:54.106667,2021-04-01,314,2021-04-01 05:40:23.369881+00:00,340,-26
20211MP76,2021,2021-04-02 05:09:52.512000,2021-04-02,309,2021-04-02 05:38:06.602261+00:00,338,-29
20211MP78,2021,2021-04-17 04:31:46.154667,2021-04-17,271,2021-04-17 05:04:49.003674+00:00,304,-33
20211MP78,2021,2021-04-18 04:31:29.424000,2021-04-18,271,2021-04-18 05:02:40.924716+00:00,302,-31
20211MP78,2021,2021-04-19 04:31:21.893333,2021-04-19,271,2021-04-19 05:00:33.680803+00:00,300,-29
20211MP80,2021,2021-04-21 04:29:49.397333,2021-04-21,269,2021-04-21 04:56:21.847588+00:00,296,-27
20211MP80,2021,2021-04-23 04:21:20.386667,2021-04-23,261,2021-04-23 04:52:13.808673+00:00,292,-31
20211MP90,2021,2021-04-10 04:57:00.704000,2021-04-10,297,2021-04-10 05:20:05.921408+00:00,320,-23
20211MP90,2021,2021-04-11 04:49:56.149333,2021-04-11,289,2021-04-11 05:17:52.995603+00:00,317,-28
20211MP90,2021,2021-04-12 04:49:27.010667,2021-04-12,289,2021-04-12 05:15:40.658633+00:00,315,-26
20211MP90,2021,2021-04-17 04:31:00.058667,2021-04-17,271,2021-04-17 05:04:49.003674+00:00,304,-33
20211MP90,2021,2021-04-18 04:32:06.960000,2021-04-18,272,2021-04-18 05:02:40.924716+00:00,302,-30
20211MP90,2021,2021-04-19 04:29:02.272000,2021-04-19,269,2021-04-19 05:00:33.680803+00:00,300,-31
20211MP92,2021,2021-04-23 04:24:40.800000,2021-04-23,264,2021-04-23 04:52:13.808673+00:00,292,-28
20211MP92,2021,2021-04-24 04:16:48.800000,2021-04-24,256,2021-04-24 04:50:11.309838+00:00,290,-34
20211MP98,2021,2021-04-14 04:37:25.624000,2021-04-14,277,2021-04-14 05:11:17.886676+00:00,311,-34
20211MP98,2021,2021-04-15 04:35:45.206667,2021-04-15,275,2021-04-15 05:09:07.520545+00:00,309,-34
20211MP98,2021,2021-04-16 04:38:45.210000,2021-04-16,278,2021-04-16 05:06:57.881000+00:00,306,-28
20211MP98,2021,2021-04-17 04:39:16.006667,2021-04-17,279,2021-04-17 05:04:49.003674+00:00,304,-25
20211MP98,2021,2021-04-18 04:35:10.602000,2021-04-18,275,2021-04-18 05:02:40.924716+00:00,302,-27
20211MP98,2021,2021-04-19 04:30:08.378667,2021-04-19,270,2021-04-19 05:00:33.680803+00:00,300,-30
20211O107,2021,2021-04-13 04:50:31.296000,2021-04-13,290,2021-04-13 05:13:28.944258+00:00,313,-23
20211O107,2021,2021-04-14 04:44:07.824000,2021-04-14,284,2021-04-14 05:11:17.886676+00:00,311,-27
20211O107,2021,2021-04-17 04:37:51.136000,2021-04-17,277,2021-04-17 05:04:49.003674+00:00,304,-27
20211O107,2021,2021-04-23 04:23:31.728000,2021-04-23,263,2021-04-23 04:52:13.808673+00:00,292,-29
20211O112,2021,2021-04-19 04:31:12.432000,2021-04-19,271,2021-04-19 05:00:33.680803+00:00,300,-29
20211O112,2021,2021-04-20 04:24:29.064000,2021-04-20,264,2021-04-20 04:58:27.309164+00:00,298,-34
20211O112,2021,2021-04-21 04:21:58.944000,2021-04-21,261,2021-04-21 04:56:21.847588+00:00,296,-35
20211O115,2021,2021-04-13 04:53:36.096000,2021-04-13,293,2021-04-13 05:13:28.944258+00:00,313,-20
20211O115,2021,2021-04-14 04:45:20.592000,2021-04-14,285,2021-04-14 05:11:17.886676+00:00,311,-26
20211O115,2021,2021-04-15 04:40:56.352000,2021-04-15,280,2021-04-15 05:09:07.520545+00:00,309,-29
20211O115,2021,2021-04-16 04:39:18.672000,2021-04-16,279,2021-04-16 05:06:57.881000+00:00,306,-27
20211O115,2021,2021-04-17 04:35:47.808000,2021-04-17,275,2021-04-17 05:04:49.003674+00:00,304,-29
20211O115,2021,2021-04-18 04:41:11.541333,2021-04-18,281,2021-04-18 05:02:40.924716+00:00,302,-21
20211O118,2021,2021-04-25 05:06:06.762667,2021-04-25,306,2021-04-25 04:48:09.878095+00:00,288,18
20211O118,2021,2021-04-26 04:00:26.880000,2021-04-26,240,2021-04-26 04:46:09.554219+00:00,286,-46
20211O12,2021,2021-04-15 04:37:15.136000,2021-04-15,277,2021-04-15 05:09:07.520545+00:00,309,-32
20211O12,2021,2021-04-16 04:53:11.157333,2021-04-16,293,2021-04-16 05:06:57.881000+00:00,306,-13
20211O12,2021,2021-04-17 04:42:52.626667,2021-04-17,282,2021-04-17 05:04:49.003674+00:00,304,-22
20211SW16,2021,2021-04-25 04:15:51.242667,2021-04-25,255,2021-04-25 04:48:09.878095+00:00,288,-33
20211SW16,2021,2021-04-27 04:16:47.568000,2021-04-27,256,2021-04-27 04:44:10.379607+00:00,284,-28
20211SW18,2021,2021-04-19 04:32:16.732000,2021-04-19,272,2021-04-19 05:00:33.680803+00:00,300,-28
20211SW32,2021,2021-04-16 05:28:02.940000,2021-04-16,328,2021-04-16 05:06:57.881000+00:00,306,22
20211SW32,2021,2021-04-17 04:30:45.162667,2021-04-17,270,2021-04-17 05:04:49.003674+00:00,304,-34
20211SW32,2021,2021-04-18 04:35:59.904000,2021-04-18,275,2021-04-18 05:02:40.924716+00:00,302,-27
20211SW34,2021,2021-04-22 04:45:17.696000,2021-04-22,285,2021-04-22 04:54:17.334440+00:00,294,-9
20211SW34,2021,2021-04-23 04:17:16.117333,2021-04-23,257,2021-04-23 04:52:13.808673+00:00,292,-35
20211SW34,2021,2021-04-24 04:24:30.876000,2021-04-24,264,2021-04-24 04:50:11.309838+00:00,290,-26
20211SW38,2021,2021-04-24 04:15:34.464000,2021-04-24,255,2021-04-24 04:50:11.309838+00:00,290,-35
20211SW49,2021,2021-04-25 04:19:38.368000,2021-04-25,259,2021-04-25 04:48:09.878095+00:00,288,-29
20211SW49,2021,2021-04-26 04:18:09.324000,2021-04-26,258,2021-04-26 04:46:09.554219+00:00,286,-28
20211SW49,2021,2021-04-27 04:16:39.733333,2021-04-27,256,2021-04-27 04:44:10.379607+00:00,284,-28
20211C61A,2021,2021-04-27 04:18:32.976000,2021-04-27,258,2021-04-27 04:44:10.379607+00:00,284,-26
20211C61A,2021,2021-04-28 04:23:32.833333,2021-04-28,263,2021-04-28 04:42:12.396280+00:00,282,-19
20211C61A,2021,2021-04-29 04:13:50.769333,2021-04-29,253,2021-04-29 04:40:15.646887+00:00,280,-27
20211C61A,2021,2021-04-30 04:15:04.941333,2021-04-30,255,2021-04-30 04:38:20.174704+00:00,278,-23
20211C62,2021,2021-04-19 04:34:57.480000,2021-04-19,274,2021-04-19 05:00:33.680803+00:00,300,-26
20211C62,2021,2021-04-21 04:47:33.692000,2021-04-21,287,2021-04-21 04:56:21.847588+00:00,296,-9
20211W74,2021,2021-04-16 04:48:44.245333,2021-04-16,288,2021-04-16 05:06:57.881000+00:00,306,-18
20211W74,2021,2021-04-18 04:51:18.665333,2021-04-18,291,2021-04-18 05:02:40.924716+00:00,302,-11
20211W75,2021,2021-04-14 04:47:03.093333,2021-04-14,287,2021-04-14 05:11:17.886676+00:00,311,-24
20211W75,2021,2021-04-15 04:30:40.272000,2021-04-15,270,2021-04-15 05:09:07.520545+00:00,309,-39
20211W75,2021,2021-04-16 04:31:45.824000,2021-04-16,271,2021-04-16 05:06:57.881000+00:00,306,-35
20211W75,2021,2021-04-17 04:30:21.264000,2021-04-17,270,2021-04-17 05:04:49.003674+00:00,304,-34
20211W75,2021,2021-04-18 04:24:24.213333,2021-04-18,264,2021-04-18 05:02:40.924716+00:00,302,-38
20211W75,2021,2021-04-20 04:22:43.264000,2021-04-20,262,2021-04-20 04:58:27.309164+00:00,298,-36
20211W75,2021,2021-04-21 04:18:37.840000,2021-04-21,258,2021-04-21 04:56:21.847588+00:00,296,-38
20211W75,2021,2021-04-22 04:18:28.736000,2021-04-22,258,2021-04-22 04:54:17.334440+00:00,294,-36
20211W77,2021,2021-04-12 04:55:46.813333,2021-04-12,295,2021-04-12 05:15:40.658633+00:00,315,-20
20211W77,2021,2021-04-13 04:44:04.224000,2021-04-13,284,2021-04-13 05:13:28.944258+00:00,313,-29
20211W79,2021,2021-04-12 04:53:11.080000,2021-04-12,293,2021-04-12 05:15:40.658633+00:00,315,-22
20211W79,2021,2021-04-13 04:40:11.649333,2021-04-13,280,2021-04-13 05:13:28.944258+00:00,313,-33
20211W79,2021,2021-04-14 04:34:33.521333,2021-04-14,274,2021-04-14 05:11:17.886676+00:00,311,-37
20211W80,2021,2021-04-23 04:19:19.974667,2021-04-23,259,2021-04-23 04:52:13.808673+00:00,292,-33
20211W80,2021,2021-04-24 04:14:37.202667,2021-04-24,254,2021-04-24 04:50:11.309838+00:00,290,-36
20211W80,2021,2021-04-25 04:10:59.573333,2021-04-25,250,2021-04-25 04:48:09.878095+00:00,288,-38
20211W81,2021,2021-04-18 04:25:22.260000,2021-04-18,265,2021-04-18 05:02:40.924716+00:00,302,-37
20211W81,2021,2021-04-19 04:23:39.826667,2021-04-19,263,2021-04-19 05:00:33.680803+00:00,300,-37
20211W81,2021,2021-04-20 04:24:29.724000,2021-04-20,264,2021-04-20 04:58:27.309164+00:00,298,-34
20211W87,2021,2021-04-13 04:37:09.330000,2021-04-13,277,2021-04-13 05:13:28.944258+00:00,313,-36
20211W87,2021,2021-04-14 04:37:39.680000,2021-04-14,277,2021-04-14 05:11:17.886676+00:00,311,-34
20211W99A,2021,2021-04-23 04:38:55.700000,2021-04-23,278,2021-04-23 04:52:13.808673+00:00,292,-14
20211W99A,2021,2021-04-24 04:20:03.066000,2021-04-24,260,2021-04-24 04:50:11.309838+00:00,290,-30
20211W99A,2021,2021-04-25 04:17:41.723333,2021-04-25,257,2021-04-25 04:48:09.878095+00:00,288,-31
20211MP34A,2021,2021-04-23 04:29:52.400000,2021-04-23,269,2021-04-23 04:52:13.808673+00:00,292,-23
20211MP34A,2021,2021-04-25 04:17:03.573333,2021-04-25,257,2021-04-25 04:48:09.878095+00:00,288,-31
20211MP42,2021,2021-04-23 04:20:54.826667,2021-04-23,260,2021-04-23 04:52:13.808673+00:00,292,-32
20211MP42,2021,2021-04-24 04:23:31.685333,2021-04-24,263,2021-04-24 04:50:11.309838+00:00,290,-27
20211MP42,2021,2021-04-25 04:19:36.168000,2021-04-25,259,2021-04-25 04:48:09.878095+00:00,288,-29
20211MP48,2021,2021-04-09 04:50:00.960000,2021-04-09,290,2021-04-09 05:22:19.402706+00:00,322,-32
20211MP48,2021,2021-04-10 04:56:28.021333,2021-04-10,296,2021-04-10 05:20:05.921408+00:00,320,-24
20211MP48,2021,2021-04-14 04:38:46.592000,2021-04-14,278,2021-04-14 05:11:17.886676+00:00,311,-33
20211MP48,2021,2021-04-15 04:38:51.712000,2021-04-15,278,2021-04-15 05:09:07.520545+00:00,309,-31
20211MP48,2021,2021-04-16 04:30:16.976000,2021-04-16,270,2021-04-16 05:06:57.881000+00:00,306,-36
20211MP51,2021,2021-04-17 04:37:29.856000,2021-04-17,277,2021-04-17 05:04:49.003674+00:00,304,-27
20211MP51,2021,2021-04-18 04:33:29.160000,2021-04-18,273,2021-04-18 05:02:40.924716+00:00,302,-29
20211MP51,2021,2021-04-19 04:29:51.722667,2021-04-19,269,2021-04-19 05:00:33.680803+00:00,300,-31
20211MP52,2021,2021-04-07 05:04:34.220000,2021-04-07,304,2021-04-07 05:26:47.900370+00:00,326,-22
20211MP52,2021,2021-04-09 05:05:21.544000,2021-04-09,305,2021-04-09 05:22:19.402706+00:00,322,-17
20211MP52,2021,2021-04-10 05:02:46.912000,2021-04-10,302,2021-04-10 05:20:05.921408+00:00,320,-18
20211MP52,2021,2021-04-11 04:58:48.224000,2021-04-11,298,2021-04-11 05:17:52.995603+00:00,317,-19
20211MP52,2021,2021-04-12 04:54:35.968000,2021-04-12,294,2021-04-12 05:15:40.658633+00:00,315,-21
20211MP56,2021,2021-04-08 05:00:40.320000,2021-04-08,300,2021-04-08 05:24:33.406551+00:00,324,-24
20211MP56,2021,2021-04-09 04:56:31.322667,2021-04-09,296,2021-04-09 05:22:19.402706+00:00,322,-26
20211MP62,2021,2021-04-20 04:23:03.488000,2021-04-20,263,2021-04-20 04:58:27.309164+00:00,298,-35
20211MP64,2021,2021-04-10 04:53:46.800000,2021-04-10,293,2021-04-10 05:20:05.921408+00:00,320,-27
20211MP64,2021,2021-04-11 04:44:05.088000,2021-04-11,284,2021-04-11 05:17:52.995603+00:00,317,-33
20211MP64,2021,2021-04-12 04:47:54.906667,2021-04-12,287,2021-04-12 05:15:40.658633+00:00,315,-28
20211MP64,2021,2021-04-13 04:34:42.272000,2021-04-13,274,2021-04-13 05:13:28.944258+00:00,313,-39
20211MP64,2021,2021-04-14 04:33:32.058667,2021-04-14,273,2021-04-14 05:11:17.886676+00:00,311,-38
20211MP64,2021,2021-04-15 04:31:12.554667,2021-04-15,271,2021-04-15 05:09:07.520545+00:00,309,-38
20211MP66,2021,2021-04-12 04:47:39.296000,2021-04-12,287,2021-04-12 05:15:40.658633+00:00,315,-28
20211MP66,2021,2021-04-13 04:39:34.933333,2021-04-13,279,2021-04-13 05:13:28.944258+00:00,313,-34
20211C108,2021,2021-04-19 04:25:43.882667,2021-04-19,265,2021-04-19 05:00:33.680803+00:00,300,-35
20211C126,2021,2021-04-24 04:43:42.816000,2021-04-24,283,2021-04-24 04:50:11.309838+00:00,290,-7
20211SW6,2021,2021-04-19 04:31:14.106667,2021-04-19,271,2021-04-19 05:00:33.680803+00:00,300,-29
20211SW6,2021,2021-04-20 04:28:44.730000,2021-04-20,268,2021-04-20 04:58:27.309164+00:00,298,-30
20211SW6,2021,2021-04-21 04:28:06.925333,2021-04-21,268,2021-04-21 04:56:21.847588+00:00,296,-28
20211SW60,2021,2021-04-25 04:20:18.613333,2021-04-25,260,2021-04-25 04:48:09.878095+00:00,288,-28
20211SW60,2021,2021-04-26 04:17:20.800000,2021-04-26,257,2021-04-26 04:46:09.554219+00:00,286,-29
20211SW60,2021,2021-04-27 04:15:45.088000,2021-04-27,255,2021-04-27 04:44:10.379607+00:00,284,-29
20211SW70,2021,2021-04-22 04:25:23.498667,2021-04-22,265,2021-04-22 04:54:17.334440+00:00,294,-29
20211SW70,2021,2021-04-23 04:15:47.498667,2021-04-23,255,2021-04-23 04:52:13.808673+00:00,292,-37
20211SW70,2021,2021-04-24 04:15:32.933333,2021-04-24,255,2021-04-24 04:50:11.309838+00:00,290,-35
20211SW72,2021,2021-04-28 04:13:34.501333,2021-04-28,253,2021-04-28 04:42:12.396280+00:00,282,-29
20211SW72,2021,2021-04-29 04:09:16.864000,2021-04-29,249,2021-04-29 04:40:15.646887+00:00,280,-31
20211SW72,2021,2021-04-30 04:07:59.125333,2021-04-30,247,2021-04-30 04:38:20.174704+00:00,278,-31
20211SW72,2021,2021-05-01 04:07:05.856000,2021-05-01,247,2021-05-01 04:36:26.023634+00:00,276,-29
20211SW76,2021,2021-04-28 04:17:15.285333,2021-04-28,257,2021-04-28 04:42:12.396280+00:00,282,-25
20211SW76,2021,2021-04-29 04:09:21.280000,2021-04-29,249,2021-04-29 04:40:15.646887+00:00,280,-31
20211SW76,2021,2021-04-30 04:08:06.933333,2021-04-30,248,2021-04-30 04:38:20.174704+00:00,278,-30
20211SW76,2021,2021-05-01 04:05:48.650667,2021-05-01,245,2021-05-01 04:36:26.023634+00:00,276,-31
20211SW82,2021,2021-04-26 04:18:24.917333,2021-04-26,258,2021-04-26 04:46:09.554219+00:00,286,-28
20211SW83,2021,2021-04-15 04:50:07.168000,2021-04-15,290,2021-04-15 05:09:07.520545+00:00,309,-19
20211SW83,2021,2021-04-16 04:45:39.669333,2021-04-16,285,2021-04-16 05:06:57.881000+00:00,306,-21
20211SW83,2021,2021-04-17 04:37:04.896000,2021-04-17,277,2021-04-17 05:04:49.003674+00:00,304,-27
20211SW83,2021,2021-04-18 04:31:44.042667,2021-04-18,271,2021-04-18 05:02:40.924716+00:00,302,-31
20211SW83,2021,2021-04-19 04:30:47.722667,2021-04-19,270,2021-04-19 05:00:33.680803+00:00,300,-30
20211SW9,2021,2021-04-27 04:14:23.818667,2021-04-27,254,2021-04-27 04:44:10.379607+00:00,284,-30
20211SW9,2021,2021-05-02 04:29:24.202667,2021-05-02,269,2021-05-02 04:34:33.238195+00:00,274,-5
20211SW90,2021,2021-04-21 04:33:51.232000,2021-04-21,273,2021-04-21 04:56:21.847588+00:00,296,-23
20211W100,2021,2021-04-13 04:49:35.868000,2021-04-13,289,2021-04-13 05:13:28.944258+00:00,313,-24
20211W100,2021,2021-04-14 04:43:28.904000,2021-04-14,283,2021-04-14 05:11:17.886676+00:00,311,-28
20211W100,2021,2021-04-15 04:40:11.173333,2021-04-15,280,2021-04-15 05:09:07.520545+00:00,309,-29
20211W100,2021,2021-04-16 04:38:29.538000,2021-04-16,278,2021-04-16 05:06:57.881000+00:00,306,-28
20211W100,2021,2021-04-18 04:34:55.194000,2021-04-18,274,2021-04-18 05:02:40.924716+00:00,302,-28
20211W102,2021,2021-04-20 04:26:09.493333,2021-04-20,266,2021-04-20 04:58:27.309164+00:00,298,-32
20211W104,2021,2021-04-24 04:15:57.110000,2021-04-24,255,2021-04-24 04:50:11.309838+00:00,290,-35
20211W104,2021,2021-04-25 04:16:19.840000,2021-04-25,256,2021-04-25 04:48:09.878095+00:00,288,-32
20211W12,2021,2021-04-27 04:16:02.948000,2021-04-27,256,2021-04-27 04:44:10.379607+00:00,284,-28
20211W12,2021,2021-04-28 04:27:33.088000,2021-04-28,267,2021-04-28 04:42:12.396280+00:00,282,-15
20211W12,2021,2021-04-29 04:11:26.056000,2021-04-29,251,2021-04-29 04:40:15.646887+00:00,280,-29
20211W12,2021,2021-04-30 04:18:11.104000,2021-04-30,258,2021-04-30 04:38:20.174704+00:00,278,-20
20211W16,2021,2021-04-12 04:50:34.453333,2021-04-12,290,2021-04-12 05:15:40.658633+00:00,315,-25
20211W16,2021,2021-04-13 04:43:21.045333,2021-04-13,283,2021-04-13 05:13:28.944258+00:00,313,-30
20211W16,2021,2021-04-15 04:37:43.826667,2021-04-15,277,2021-04-15 05:09:07.520545+00:00,309,-32
20211W16,2021,2021-04-16 04:35:05.856000,2021-04-16,275,2021-04-16 05:06:57.881000+00:00,306,-31
20211W16,2021,2021-04-17 04:31:49.077333,2021-04-17,271,2021-04-17 05:04:49.003674+00:00,304,-33
20211W16,2021,2021-04-18 04:27:21.770667,2021-04-18,267,2021-04-18 05:02:40.924716+00:00,302,-35
20211W16,2021,2021-04-19 04:27:10.592000,2021-04-19,267,2021-04-19 05:00:33.680803+00:00,300,-33
20211W16,2021,2021-04-20 04:31:27.056000,2021-04-20,271,2021-04-20 04:58:27.309164+00:00,298,-27
20211W17,2021,2021-04-24 04:28:36.117333,2021-04-24,268,2021-04-24 04:50:11.309838+00:00,290,-22
20211W17,2021,2021-04-25 04:31:22.216000,2021-04-25,271,2021-04-25 04:48:09.878095+00:00,288,-17
20211W21,2021,2021-04-23 04:23:13.320000,2021-04-23,263,2021-04-23 04:52:13.808673+00:00,292,-29
20211W21,2021,2021-04-24 04:21:15.512000,2021-04-24,261,2021-04-24 04:50:11.309838+00:00,290,-29
20211W21,2021,2021-04-25 04:25:15.746667,2021-04-25,265,2021-04-25 04:48:09.878095+00:00,288,-23
20211P11,2021,2021-04-24 04:19:39.690667,2021-04-24,259,2021-04-24 04:50:11.309838+00:00,290,-31
20211P11,2021,2021-04-26 04:19:28.992000,2021-04-26,259,2021-04-26 04:46:09.554219+00:00,286,-27
20211P12,2021,2021-04-26 04:18:23.904000,2021-04-26,258,2021-04-26 04:46:09.554219+00:00,286,-28
20211P12,2021,2021-04-27 04:24:49.728000,2021-04-27,264,2021-04-27 04:44:10.379607+00:00,284,-20
20211P12,2021,2021-04-29 04:32:33.621333,2021-04-29,272,2021-04-29 04:40:15.646887+00:00,280,-8
20211O3,2021,2021-04-18 04:27:51.864000,2021-04-18,267,2021-04-18 05:02:40.924716+00:00,302,-35
20211O3,2021,2021-04-19 04:27:02.600000,2021-04-19,267,2021-04-19 05:00:33.680803+00:00,300,-33
20211O3,2021,2021-04-20 04:24:32.106667,2021-04-20,264,2021-04-20 04:58:27.309164+00:00,298,-34
20211O30,2021,2021-04-15 04:32:43.710000,2021-04-15,272,2021-04-15 05:09:07.520545+00:00,309,-37
20211O30,2021,2021-04-16 04:31:30.158667,2021-04-16,271,2021-04-16 05:06:57.881000+00:00,306,-35
20211O30,2021,2021-04-17 04:28:39.582667,2021-04-17,268,2021-04-17 05:04:49.003674+00:00,304,-36
20211O34,2021,2021-04-27 04:23:29.496000,2021-04-27,263,2021-04-27 04:44:10.379607+00:00,284,-21
20211O34,2021,2021-04-28 04:26:20.693333,2021-04-28,266,2021-04-28 04:42:12.396280+00:00,282,-16
20211O34,2021,2021-04-29 04:22:00.000000,2021-04-29,262,2021-04-29 04:40:15.646887+00:00,280,-18
20211O34,2021,2021-04-30 04:16:51.845333,2021-04-30,256,2021-04-30 04:38:20.174704+00:00,278,-22
20211O34,2021,2021-05-01 04:16:35.424000,2021-05-01,256,2021-05-01 04:36:26.023634+00:00,276,-20
20211O44,2021,2021-04-22 04:19:23.093333,2021-04-22,259,2021-04-22 04:54:17.334440+00:00,294,-35
20211O44,2021,2021-04-23 04:17:30.480000,2021-04-23,257,2021-04-23 04:52:13.808673+00:00,292,-35
20211O44,2021,2021-04-24 04:14:30.773333,2021-04-24,254,2021-04-24 04:50:11.309838+00:00,290,-36
20211O48,2021,2021-04-19 04:30:26.053333,2021-04-19,270,2021-04-19 05:00:33.680803+00:00,300,-30
20211O48,2021,2021-04-21 04:28:16.221333,2021-04-21,268,2021-04-21 04:56:21.847588+00:00,296,-28
20211EX62F,2021,2021-05-02 03:55:37.008000,2021-05-02,235,2021-05-02 04:34:33.238195+00:00,274,-39
20211EX62F,2021,2021-05-03 03:59:44.085333,2021-05-03,239,2021-05-03 04:32:41.863520+00:00,272,-33
20211EX62F,2021,2021-05-04 04:01:18.768000,2021-05-04,241,2021-05-04 04:30:51.945344+00:00,270,-29
20211EX62F,2021,2021-05-05 03:51:11.754667,2021-05-05,231,2021-05-05 04:29:03.529987+00:00,269,-38
20211EX62F,2021,2021-05-06 03:52:17.253333,2021-05-06,232,2021-05-06 04:27:16.664342+00:00,267,-35
20211EX62F,2021,2021-05-07 03:54:51.082667,2021-05-07,234,2021-05-07 04:25:31.395851+00:00,265,-31
20211EX65,2021,2021-04-23 04:22:14.208000,2021-04-23,262,2021-04-23 04:52:13.808673+00:00,292,-30
20211EX65,2021,2021-04-24 04:20:12.938667,2021-04-24,260,2021-04-24 04:50:11.309838+00:00,290,-30
20211EX65,2021,2021-04-25 04:19:12.768000,2021-04-25,259,2021-04-25 04:48:09.878095+00:00,288,-29
20211EX66,2021,2021-04-20 04:29:16.384000,2021-04-20,269,2021-04-20 04:58:27.309164+00:00,298,-29
20211EX66,2021,2021-04-21 04:27:16.320000,2021-04-21,267,2021-04-21 04:56:21.847588+00:00,296,-29
20211EX75,2021,2021-04-23 04:23:23.157333,2021-04-23,263,2021-04-23 04:52:13.808673+00:00,292,-29
20211EX75,2021,2021-04-24 04:22:49.032000,2021-04-24,262,2021-04-24 04:50:11.309838+00:00,290,-28
20211EX75,2021,2021-04-25 04:26:19.648000,2021-04-25,266,2021-04-25 04:48:09.878095+00:00,288,-22
20211EX76,2021,2021-04-20 04:31:07.104000,2021-04-20,271,2021-04-20 04:58:27.309164+00:00,298,-27
20211EX76,2021,2021-04-21 04:30:17.797333,2021-04-21,270,2021-04-21 04:56:21.847588+00:00,296,-26
20211EX76,2021,2021-04-22 04:28:22.813333,2021-04-22,268,2021-04-22 04:54:17.334440+00:00,294,-26
20211EX78,2021,2021-04-25 04:32:45.973333,2021-04-25,272,2021-04-25 04:48:09.878095+00:00,288,-16
20211MP12,2021,2021-04-18 04:23:35.941333,2021-04-18,263,2021-04-18 05:02:40.924716+00:00,302,-39
20211MP12,2021,2021-04-19 04:22:13.752000,2021-04-19,262,2021-04-19 05:00:33.680803+00:00,300,-38
20211MP12,2021,2021-04-20 04:21:00.864000,2021-04-20,261,2021-04-20 04:58:27.309164+00:00,298,-37
20211W36,2021,2021-04-23 04:43:37.216000,2021-04-23,283,2021-04-23 04:52:13.808673+00:00,292,-9
20211W36,2021,2021-04-25 04:14:55.360000,2021-04-25,254,2021-04-25 04:48:09.878095+00:00,288,-34
20211W36,2021,2021-04-26 04:20:48.554667,2021-04-26,260,2021-04-26 04:46:09.554219+00:00,286,-26
20211W36,2021,2021-04-27 04:27:18.890667,2021-04-27,267,2021-04-27 04:44:10.379607+00:00,284,-17
20211W36,2021,2021-04-28 04:34:35.861333,2021-04-28,274,2021-04-28 04:42:12.396280+00:00,282,-8
20211W37,2021,2021-04-08 04:58:27.373333,2021-04-08,298,2021-04-08 05:24:33.406551+00:00,324,-26
20211W37,2021,2021-04-09 05:13:34.816000,2021-04-09,313,2021-04-09 05:22:19.402706+00:00,322,-9
20211W37,2021,2021-04-10 04:54:52.992000,2021-04-10,294,2021-04-10 05:20:05.921408+00:00,320,-26
20211W40,2021,2021-04-23 04:17:46.896000,2021-04-23,257,2021-04-23 04:52:13.808673+00:00,292,-35
20211W40,2021,2021-04-24 04:16:05.589333,2021-04-24,256,2021-04-24 04:50:11.309838+00:00,290,-34
20211W40,2021,2021-04-25 04:14:59.712000,2021-04-25,254,2021-04-25 04:48:09.878095+00:00,288,-34
20211W42,2021,2021-04-21 04:22:14.496000,2021-04-21,262,2021-04-21 04:56:21.847588+00:00,296,-34
20211W42,2021,2021-04-23 04:22:21.536000,2021-04-23,262,2021-04-23 04:52:13.808673+00:00,292,-30
20211W4B,2021,2021-04-20 04:29:00.501333,2021-04-20,269,2021-04-20 04:58:27.309164+00:00,298,-29
20211W4B,2021,2021-04-21 04:29:02.586667,2021-04-21,269,2021-04-21 04:56:21.847588+00:00,296,-27
20211W4B,2021,2021-04-22 04:29:42.613333,2021-04-22,269,2021-04-22 04:54:17.334440+00:00,294,-25
20211W5,2021,2021-04-20 04:23:53.096000,2021-04-20,263,2021-04-20 04:58:27.309164+00:00,298,-35
20211W5,2021,2021-04-21 04:19:15.373333,2021-04-21,259,2021-04-21 04:56:21.847588+00:00,296,-37
20211W5,2021,2021-04-22 04:22:57.024000,2021-04-22,262,2021-04-22 04:54:17.334440+00:00,294,-32
20211W51,2021,2021-04-12 04:55:39.013333,2021-04-12,295,2021-04-12 05:15:40.658633+00:00,315,-20
20211W51,2021,2021-04-13 04:45:29.568000,2021-04-13,285,2021-04-13 05:13:28.944258+00:00,313,-28
20211W51,2021,2021-04-14 04:41:00.864000,2021-04-14,281,2021-04-14 05:11:17.886676+00:00,311,-30
20211W55,2021,2021-04-15 04:39:19.128000,2021-04-15,279,2021-04-15 05:09:07.520545+00:00,309,-30
20211W55,2021,2021-04-16 04:37:38.261333,2021-04-16,277,2021-04-16 05:06:57.881000+00:00,306,-29
20211W55,2021,2021-04-17 04:36:09.386667,2021-04-17,276,2021-04-17 05:04:49.003674+00:00,304,-28
20211W56,2021,2021-04-30 04:05:13.704000,2021-04-30,245,2021-04-30 04:38:20.174704+00:00,278,-33
20211W56,2021,2021-05-02 04:01:14.704000,2021-05-02,241,2021-05-02 04:34:33.238195+00:00,274,-33
20211W64,2021,2021-04-18 04:31:39.184000,2021-04-18,271,2021-04-18 05:02:40.924716+00:00,302,-31
20211W64,2021,2021-04-19 04:24:50.736000,2021-04-19,264,2021-04-19 05:00:33.680803+00:00,300,-36
20211W64,2021,2021-04-20 04:21:30.730667,2021-04-20,261,2021-04-20 04:58:27.309164+00:00,298,-37
20211W64A,2021,2021-04-12 04:52:02.578667,2021-04-12,292,2021-04-12 05:15:40.658633+00:00,315,-23
20211W64A,2021,2021-04-13 04:41:41.652000,2021-04-13,281,2021-04-13 05:13:28.944258+00:00,313,-32
20211W64A,2021,2021-04-14 04:42:02.528000,2021-04-14,282,2021-04-14 05:11:17.886676+00:00,311,-29
20211W67,2021,2021-04-21 04:30:01.192000,2021-04-21,270,2021-04-21 04:56:21.847588+00:00,296,-26
20211W67,2021,2021-04-22 04:33:28.896000,2021-04-22,273,2021-04-22 04:54:17.334440+00:00,294,-21
20211W67,2021,2021-04-23 04:32:37.461333,2021-04-23,272,2021-04-23 04:52:13.808673+00:00,292,-20
20221B101,2022,2022-04-19 04:28:08.586667,2022-04-19,268,2022-04-19 05:01:04.224113+00:00,301,-33
20221B101,2022,2022-04-20 04:37:21.632000,2022-04-20,277,2022-04-20 04:58:57.635019+00:00,298,-21
20221B101,2022,2022-04-21 04:34:47.549333,2022-04-21,274,2022-04-21 04:56:51.946833+00:00,296,-22
20221B116,2022,2022-04-28 04:15:42.960000,2022-04-28,255,2022-04-28 04:42:40.640973+00:00,282,-27
20221B116,2022,2022-04-29 04:10:54.405333,2022-04-29,250,2022-04-29 04:40:43.586566+00:00,280,-30
20221B116,2022,2022-04-30 04:04:56.277333,2022-04-30,244,2022-04-30 04:38:47.798905+00:00,278,-34
20221B163,2022,2022-04-13 04:45:45.648000,2022-04-13,285,2022-04-13 05:14:00.607320+00:00,314,-29
20221B163,2022,2022-04-14 04:42:34.029333,2022-04-14,282,2022-04-14 05:11:49.384513+00:00,311,-29
20221B163,2022,2022-04-15 04:38:38.912000,2022-04-15,278,2022-04-15 05:09:38.844755+00:00,309,-31
20221B169,2022,2022-04-22 04:38:53.856000,2022-04-22,278,2022-04-22 04:54:47.197779+00:00,294,-16
20221B169,2022,2022-04-23 04:36:55.306667,2022-04-23,276,2022-04-23 04:52:43.426672+00:00,292,-16
20221B169,2022,2022-04-24 04:29:34.800000,2022-04-24,269,2022-04-24 04:50:40.672918+00:00,290,-21
20221B171,2022,2022-04-19 04:32:52.480000,2022-04-19,272,2022-04-19 05:01:04.224113+00:00,301,-29
20221B171,2022,2022-04-20 04:32:57.546667,2022-04-20,272,2022-04-20 04:58:57.635019+00:00,298,-26
20221B171,2022,2022-04-21 04:33:36.362667,2022-04-21,273,2022-04-21 04:56:51.946833+00:00,296,-23
20221B175,2022,2022-04-19 04:24:51.797333,2022-04-19,264,2022-04-19 05:01:04.224113+00:00,301,-37
20221B175,2022,2022-04-20 04:35:10.122667,2022-04-20,275,2022-04-20 04:58:57.635019+00:00,298,-23
20221B175,2022,2022-04-21 04:40:00.576000,2022-04-21,280,2022-04-21 04:56:51.946833+00:00,296,-16
20221B203,2022,2022-04-15 04:39:38.842667,2022-04-15,279,2022-04-15 05:09:38.844755+00:00,309,-30
20221B203,2022,2022-04-16 04:42:40.912000,2022-04-16,282,2022-04-16 05:07:29.023067+00:00,307,-25
20221B203,2022,2022-04-17 04:37:25.845333,2022-04-17,277,2022-04-17 05:05:19.954960+00:00,305,-28
20221O109,2022,2022-04-14 05:01:23.528000,2022-04-14,301,2022-04-14 05:11:49.384513+00:00,311,-10
20221O109,2022,2022-04-15 04:50:25.857333,2022-04-15,290,2022-04-15 05:09:38.844755+00:00,309,-19
20221O109,2022,2022-04-16 04:55:33.653333,2022-04-16,295,2022-04-16 05:07:29.023067+00:00,307,-12
20221O11,2022,2022-04-14 04:45:19.626667,2022-04-14,285,2022-04-14 05:11:49.384513+00:00,311,-26
20221O11,2022,2022-04-15 04:42:48.768000,2022-04-15,282,2022-04-15 05:09:38.844755+00:00,309,-27
20221O113,2022,2022-04-28 04:40:00.048000,2022-04-28,280,2022-04-28 04:42:40.640973+00:00,282,-2
20221O119,2022,2022-04-21 04:34:33.088000,2022-04-21,274,2022-04-21 04:56:51.946833+00:00,296,-22
20221O14,2022,2022-04-14 04:46:36.720000,2022-04-14,286,2022-04-14 05:11:49.384513+00:00,311,-25
20221O14,2022,2022-04-15 04:42:53.520000,2022-04-15,282,2022-04-15 05:09:38.844755+00:00,309,-27
20221O14,2022,2022-04-16 04:46:02.853333,2022-04-16,286,2022-04-16 05:07:29.023067+00:00,307,-21
20221O21,2022,2022-04-14 04:38:45.437333,2022-04-14,278,2022-04-14 05:11:49.384513+00:00,311,-33
20221O21,2022,2022-04-15 04:36:33.184000,2022-04-15,276,2022-04-15 05:09:38.844755+00:00,309,-33
20221O21,2022,2022-04-16 04:37:07.978667,2022-04-16,277,2022-04-16 05:07:29.023067+00:00,307,-30
20221O26,2022,2022-04-09 04:48:05.533333,2022-04-09,288,2022-04-09 05:22:51.644800+00:00,322,-34
20221O26,2022,2022-04-11 04:48:26.706667,2022-04-11,288,2022-04-11 05:18:24.964349+00:00,318,-30
20221O26,2022,2022-04-12 04:55:14.733333,2022-04-12,295,2022-04-12 05:16:12.478629+00:00,316,-21
20221O26,2022,2022-04-13 05:06:55.253333,2022-04-13,306,2022-04-13 05:14:00.607320+00:00,314,-8
20221O26,2022,2022-04-14 04:51:33.653333,2022-04-14,291,2022-04-14 05:11:49.384513+00:00,311,-20
20221O27,2022,2022-04-11 04:59:12.490667,2022-04-11,299,2022-04-11 05:18:24.964349+00:00,318,-19
20221O27,2022,2022-04-12 05:04:20.592000,2022-04-12,304,2022-04-12 05:16:12.478629+00:00,316,-12
20221O27,2022,2022-04-13 04:57:18.466667,2022-04-13,297,2022-04-13 05:14:00.607320+00:00,314,-17
20221O29,2022,2022-04-26 04:25:02.688000,2022-04-26,265,2022-04-26 04:46:38.378143+00:00,286,-21
20221O29,2022,2022-04-27 04:20:33.493333,2022-04-27,260,2022-04-27 04:44:38.918999+00:00,284,-24
20221O29,2022,2022-04-28 04:18:22.506667,2022-04-28,258,2022-04-28 04:42:40.640973+00:00,282,-24
20221O29,2022,2022-04-29 04:36:29.520000,2022-04-29,276,2022-04-29 04:40:43.586566+00:00,280,-4
20221O29,2022,2022-04-30 04:18:44.720000,2022-04-30,258,2022-04-30 04:38:47.798905+00:00,278,-20
20221O29,2022,2022-05-01 04:24:00.982667,2022-05-01,264,2022-05-01 04:36:53.321744+00:00,276,-12
20221O29,2022,2022-05-02 04:13:35.957333,2022-05-02,253,2022-05-02 04:35:00.199457+00:00,275,-22
20221O33,2022,2022-04-21 04:34:52.373333,2022-04-21,274,2022-04-21 04:56:51.946833+00:00,296,-22
20221O33,2022,2022-04-22 04:31:20.682667,2022-04-22,271,2022-04-22 04:54:47.197779+00:00,294,-23
20221O33,2022,2022-04-23 04:35:41.120000,2022-04-23,275,2022-04-23 04:52:43.426672+00:00,292,-17
20221O33,2022,2022-04-24 04:32:35.221333,2022-04-24,272,2022-04-24 04:50:40.672918+00:00,290,-18
20221O33,2022,2022-04-25 04:22:13.632000,2022-04-25,262,2022-04-25 04:48:38.976532+00:00,288,-26
20221O37,2022,2022-04-08 04:52:35.712000,2022-04-08,292,2022-04-08 05:25:05.773430+00:00,325,-33
20221O37,2022,2022-04-09 04:51:17.312000,2022-04-09,291,2022-04-09 05:22:51.644800+00:00,322,-31
20221O37,2022,2022-04-10 04:50:10.592000,2022-04-10,290,2022-04-10 05:20:38.030821+00:00,320,-30
20221O37,2022,2022-04-11 04:47:41.632000,2022-04-11,287,2022-04-11 05:18:24.964349+00:00,318,-31
20221O37,2022,2022-04-12 04:54:45.365333,2022-04-12,294,2022-04-12 05:16:12.478629+00:00,316,-22
20221O37,2022,2022-04-13 04:43:13.552000,2022-04-13,283,2022-04-13 05:14:00.607320+00:00,314,-31
20221O38B,2022,2022-04-08 04:54:22.672000,2022-04-08,294,2022-04-08 05:25:05.773430+00:00,325,-31
20221O38B,2022,2022-04-09 04:53:46.178667,2022-04-09,293,2022-04-09 05:22:51.644800+00:00,322,-29
20221O38B,2022,2022-04-10 04:53:20.080000,2022-04-10,293,2022-04-10 05:20:38.030821+00:00,320,-27
20221O38B,2022,2022-04-11 04:55:07.882667,2022-04-11,295,2022-04-11 05:18:24.964349+00:00,318,-23
20221O4,2022,2022-04-09 04:54:35.712000,2022-04-09,294,2022-04-09 05:22:51.644800+00:00,322,-28
20221O4,2022,2022-04-10 04:58:52.480000,2022-04-10,298,2022-04-10 05:20:38.030821+00:00,320,-22
20221O4,2022,2022-04-11 04:48:09.984000,2022-04-11,288,2022-04-11 05:18:24.964349+00:00,318,-30
20221O45,2022,2022-04-14 04:42:47.658667,2022-04-14,282,2022-04-14 05:11:49.384513+00:00,311,-29
20221O45,2022,2022-04-16 04:44:20.544000,2022-04-16,284,2022-04-16 05:07:29.023067+00:00,307,-23
20221SW12,2022,2022-04-13 04:47:47.504000,2022-04-13,287,2022-04-13 05:14:00.607320+00:00,314,-27
20221SW12,2022,2022-04-14 04:42:50.453333,2022-04-14,282,2022-04-14 05:11:49.384513+00:00,311,-29
20221SW122,2022,2022-04-14 04:53:19.360000,2022-04-14,293,2022-04-14 05:11:49.384513+00:00,311,-18
20221SW122,2022,2022-04-15 04:45:04.725333,2022-04-15,285,2022-04-15 05:09:38.844755+00:00,309,-24
20221SW122,2022,2022-04-16 04:44:10.773333,2022-04-16,284,2022-04-16 05:07:29.023067+00:00,307,-23
20221SW122,2022,2022-04-17 04:39:02.218667,2022-04-17,279,2022-04-17 05:05:19.954960+00:00,305,-26
20221SW122,2022,2022-04-18 04:40:56.160000,2022-04-18,280,2022-04-18 05:03:11.676458+00:00,303,-23
20221SW122,2022,2022-04-19 04:39:24.864000,2022-04-19,279,2022-04-19 05:01:04.224113+00:00,301,-22
20221SW16,2022,2022-04-22 04:28:44.004000,2022-04-22,268,2022-04-22 04:54:47.197779+00:00,294,-26
20221SW16,2022,2022-04-23 04:29:24.616000,2022-04-23,269,2022-04-23 04:52:43.426672+00:00,292,-23
20221SW19,2022,2022-04-18 04:28:09.333333,2022-04-18,268,2022-04-18 05:03:11.676458+00:00,303,-35
20221SW19,2022,2022-04-19 04:28:49.344000,2022-04-19,268,2022-04-19 05:01:04.224113+00:00,301,-33
20221SW19,2022,2022-04-20 04:40:06.784000,2022-04-20,280,2022-04-20 04:58:57.635019+00:00,298,-18
20221SW28,2022,2022-04-19 04:35:05.328000,2022-04-19,275,2022-04-19 05:01:04.224113+00:00,301,-26
20221SW28,2022,2022-04-20 04:38:33.968000,2022-04-20,278,2022-04-20 04:58:57.635019+00:00,298,-20
20221SW28,2022,2022-04-21 04:29:05.968000,2022-04-21,269,2022-04-21 04:56:51.946833+00:00,296,-27
20221SW28,2022,2022-04-22 04:36:52.928000,2022-04-22,276,2022-04-22 04:54:47.197779+00:00,294,-18
20221SW28,2022,2022-04-23 04:38:56.597333,2022-04-23,278,2022-04-23 04:52:43.426672+00:00,292,-14
20221SW28,2022,2022-04-25 04:22:59.856000,2022-04-25,262,2022-04-25 04:48:38.976532+00:00,288,-26
20221SW28,2022,2022-04-26 04:21:04.386667,2022-04-26,261,2022-04-26 04:46:38.378143+00:00,286,-25
20221SW28,2022,2022-04-27 04:22:50.560000,2022-04-27,262,2022-04-27 04:44:38.918999+00:00,284,-22
20221SW32,2022,2022-04-22 04:47:47.736000,2022-04-22,287,2022-04-22 04:54:47.197779+00:00,294,-7
20221SW32,2022,2022-04-23 04:57:36.816000,2022-04-23,297,2022-04-23 04:52:43.426672+00:00,292,5
20221SW32,2022,2022-04-24 04:44:58.346667,2022-04-24,284,2022-04-24 04:50:40.672918+00:00,290,-6
20221SW33,2022,2022-04-17 04:33:32.000000,2022-04-17,273,2022-04-17 05:05:19.954960+00:00,305,-32
20221SW33,2022,2022-04-18 04:24:24.565333,2022-04-18,264,2022-04-18 05:03:11.676458+00:00,303,-39
20221SW33,2022,2022-04-19 04:26:36.672000,2022-04-19,266,2022-04-19 05:01:04.224113+00:00,301,-35
20221SW33,2022,2022-04-22 04:28:27.008000,2022-04-22,268,2022-04-22 04:54:47.197779+00:00,294,-26
20221SW33,2022,2022-04-23 04:32:17.408000,2022-04-23,272,2022-04-23 04:52:43.426672+00:00,292,-20
20221SW33,2022,2022-04-24 04:27:50.656000,2022-04-24,267,2022-04-24 04:50:40.672918+00:00,290,-23
20221SW33,2022,2022-04-25 04:21:55.178667,2022-04-25,261,2022-04-25 04:48:38.976532+00:00,288,-27
20221SW33,2022,2022-04-26 04:21:47.306667,2022-04-26,261,2022-04-26 04:46:38.378143+00:00,286,-25
20221SW33,2022,2022-04-27 04:14:54.400000,2022-04-27,254,2022-04-27 04:44:38.918999+00:00,284,-30
20221CP3,2022,2022-04-20 04:32:06.176000,2022-04-20,272,2022-04-20 04:58:57.635019+00:00,298,-26
20221CP3,2022,2022-04-21 04:23:11.676000,2022-04-21,263,2022-04-21 04:56:51.946833+00:00,296,-33
20221CP3,2022,2022-04-22 04:30:10.517333,2022-04-22,270,2022-04-22 04:54:47.197779+00:00,294,-24
20221CP30,2022,2022-04-20 04:31:49.578667,2022-04-20,271,2022-04-20 04:58:57.635019+00:00,298,-27
20221CP30,2022,2022-04-21 04:31:13.760000,2022-04-21,271,2022-04-21 04:56:51.946833+00:00,296,-25
20221CP30,2022,2022-04-22 04:34:38.677333,2022-04-22,274,2022-04-22 04:54:47.197779+00:00,294,-20
20221CP33,2022,2022-04-16 04:41:07.669333,2022-04-16,281,2022-04-16 05:07:29.023067+00:00,307,-26
20221CP33,2022,2022-04-17 04:40:14.794667,2022-04-17,280,2022-04-17 05:05:19.954960+00:00,305,-25
20221CP33,2022,2022-04-18 04:33:24.800000,2022-04-18,273,2022-04-18 05:03:11.676458+00:00,303,-30
20221CP40,2022,2022-04-13 04:42:29.440000,2022-04-13,282,2022-04-13 05:14:00.607320+00:00,314,-32
20221CP40,2022,2022-04-14 04:39:46.032000,2022-04-14,279,2022-04-14 05:11:49.384513+00:00,311,-32
20221CP40,2022,2022-04-15 04:43:45.280000,2022-04-15,283,2022-04-15 05:09:38.844755+00:00,309,-26
20221CP42A,2022,2022-04-13 04:38:45.624000,2022-04-13,278,2022-04-13 05:14:00.607320+00:00,314,-36
20221CP42A,2022,2022-04-14 04:48:09.114667,2022-04-14,288,2022-04-14 05:11:49.384513+00:00,311,-23
20221CP42A,2022,2022-04-15 04:38:47.232000,2022-04-15,278,2022-04-15 05:09:38.844755+00:00,309,-31
20221CP5A,2022,2022-04-07 04:55:50.752000,2022-04-07,295,2022-04-07 05:27:20.384224+00:00,327,-32
20221CP5A,2022,2022-04-08 04:54:13.973333,2022-04-08,294,2022-04-08 05:25:05.773430+00:00,325,-31
20221CP5A,2022,2022-04-09 04:47:42.176000,2022-04-09,287,2022-04-09 05:22:51.644800+00:00,322,-35
20221CP5A,2022,2022-04-10 04:43:10.392000,2022-04-10,283,2022-04-10 05:20:38.030821+00:00,320,-37
20221CP7,2022,2022-04-21 04:27:49.696000,2022-04-21,267,2022-04-21 04:56:51.946833+00:00,296,-29
20221CP7,2022,2022-04-22 04:31:58.688000,2022-04-22,271,2022-04-22 04:54:47.197779+00:00,294,-23
20221CP7,2022,2022-04-23 04:31:13.946667,2022-04-23,271,2022-04-23 04:52:43.426672+00:00,292,-21
20221EX10,2022,2022-04-16 04:32:20.032000,2022-04-16,272,2022-04-16 05:07:29.023067+00:00,307,-35
20221EX10,2022,2022-04-17 04:33:34.090667,2022-04-17,273,2022-04-17 05:05:19.954960+00:00,305,-32
20221EX10,2022,2022-04-18 04:32:09.632000,2022-04-18,272,2022-04-18 05:03:11.676458+00:00,303,-31
20221EX13,2022,2022-04-13 04:47:18.528000,2022-04-13,287,2022-04-13 05:14:00.607320+00:00,314,-27
20221EX13,2022,2022-04-16 04:40:11.648000,2022-04-16,280,2022-04-16 05:07:29.023067+00:00,307,-27
20221EX13,2022,2022-04-17 04:44:32.026667,2022-04-17,284,2022-04-17 05:05:19.954960+00:00,305,-21
20221EX13,2022,2022-04-18 04:38:11.029333,2022-04-18,278,2022-04-18 05:03:11.676458+00:00,303,-25
20221EX13A,2022,2022-04-20 04:33:23.136000,2022-04-20,273,2022-04-20 04:58:57.635019+00:00,298,-25
20221EX13A,2022,2022-04-21 04:29:37.040000,2022-04-21,269,2022-04-21 04:56:51.946833+00:00,296,-27
20221EX13A,2022,2022-04-22 04:31:23.200000,2022-04-22,271,2022-04-22 04:54:47.197779+00:00,294,-23
20221EX15,2022,2022-04-16 04:39:45.190000,2022-04-16,279,2022-04-16 05:07:29.023067+00:00,307,-28
20221EX15,2022,2022-04-17 04:36:16.448000,2022-04-17,276,2022-04-17 05:05:19.954960+00:00,305,-29
20221EX15,2022,2022-04-18 04:37:54.896000,2022-04-18,277,2022-04-18 05:03:11.676458+00:00,303,-26
20221SW49A,2022,2022-04-16 04:31:19.500000,2022-04-16,271,2022-04-16 05:07:29.023067+00:00,307,-36
20221SW49A,2022,2022-04-17 04:29:28.752000,2022-04-17,269,2022-04-17 05:05:19.954960+00:00,305,-36
20221SW49A,2022,2022-04-18 04:33:05.440000,2022-04-18,273,2022-04-18 05:03:11.676458+00:00,303,-30
20221SW5,2022,2022-04-12 04:54:47.666667,2022-04-12,294,2022-04-12 05:16:12.478629+00:00,316,-22
20221SW5,2022,2022-04-13 04:44:55.440000,2022-04-13,284,2022-04-13 05:14:00.607320+00:00,314,-30
20221SW5,2022,2022-04-14 04:35:47.791333,2022-04-14,275,2022-04-14 05:11:49.384513+00:00,311,-36
20221SW60,2022,2022-04-21 04:21:40.138667,2022-04-21,261,2022-04-21 04:56:51.946833+00:00,296,-35
20221SW60,2022,2022-04-22 04:22:13.322667,2022-04-22,262,2022-04-22 04:54:47.197779+00:00,294,-32
20221SW60,2022,2022-04-23 04:22:32.384000,2022-04-23,262,2022-04-23 04:52:43.426672+00:00,292,-30
20221SW72,2022,2022-04-19 04:40:13.184000,2022-04-19,280,2022-04-19 05:01:04.224113+00:00,301,-21
20221SW72,2022,2022-04-20 04:51:21.171333,2022-04-20,291,2022-04-20 04:58:57.635019+00:00,298,-7
20221SW72,2022,2022-04-21 04:35:20.064000,2022-04-21,275,2022-04-21 04:56:51.946833+00:00,296,-21
20221SW73,2022,2022-04-15 04:29:20.960000,2022-04-15,269,2022-04-15 05:09:38.844755+00:00,309,-40
20221SW73,2022,2022-04-16 04:34:38.800000,2022-04-16,274,2022-04-16 05:07:29.023067+00:00,307,-33
20221SW73,2022,2022-04-17 04:30:27.144000,2022-04-17,270,2022-04-17 05:05:19.954960+00:00,305,-35
20221SW73,2022,2022-04-19 04:32:57.653333,2022-04-19,272,2022-04-19 05:01:04.224113+00:00,301,-29
20221SW73,2022,2022-04-20 04:38:19.840000,2022-04-20,278,2022-04-20 04:58:57.635019+00:00,298,-20
20221SW73,2022,2022-04-21 04:48:43.904000,2022-04-21,288,2022-04-21 04:56:51.946833+00:00,296,-8
20221SW81,2022,2022-04-21 04:38:57.309333,2022-04-21,278,2022-04-21 04:56:51.946833+00:00,296,-18
20221SW81,2022,2022-04-22 04:55:09.898667,2022-04-22,295,2022-04-22 04:54:47.197779+00:00,294,1
20221C157,2022,2022-04-10 04:49:12.413333,2022-04-10,289,2022-04-10 05:20:38.030821+00:00,320,-31
20221C157,2022,2022-04-11 04:48:04.000000,2022-04-11,288,2022-04-11 05:18:24.964349+00:00,318,-30
20221C157,2022,2022-04-12 04:56:15.232000,2022-04-12,296,2022-04-12 05:16:12.478629+00:00,316,-20
20221EX63,2022,2022-04-12 04:58:28.372000,2022-04-12,298,2022-04-12 05:16:12.478629+00:00,316,-18
20221EX63,2022,2022-04-13 04:45:50.813333,2022-04-13,285,2022-04-13 05:14:00.607320+00:00,314,-29
20221EX63,2022,2022-04-14 04:34:17.600000,2022-04-14,274,2022-04-14 05:11:49.384513+00:00,311,-37
20221EX63,2022,2022-04-15 04:31:46.176000,2022-04-15,271,2022-04-15 05:09:38.844755+00:00,309,-38
20221EX63,2022,2022-04-16 04:41:43.946667,2022-04-16,281,2022-04-16 05:07:29.023067+00:00,307,-26
20221EX63,2022,2022-04-17 04:30:45.573333,2022-04-17,270,2022-04-17 05:05:19.954960+00:00,305,-35
20221O56,2022,2022-04-14 04:41:58.973333,2022-04-14,281,2022-04-14 05:11:49.384513+00:00,311,-30
20221O56,2022,2022-04-15 04:41:39.157333,2022-04-15,281,2022-04-15 05:09:38.844755+00:00,309,-28
20221O56,2022,2022-04-16 04:47:22.000000,2022-04-16,287,2022-04-16 05:07:29.023067+00:00,307,-20
20221SW106,2022,2022-04-17 04:39:24.554667,2022-04-17,279,2022-04-17 05:05:19.954960+00:00,305,-26
20221SW106,2022,2022-04-18 04:39:56.928000,2022-04-18,279,2022-04-18 05:03:11.676458+00:00,303,-24
20221SW106,2022,2022-04-19 04:41:16.288000,2022-04-19,281,2022-04-19 05:01:04.224113+00:00,301,-20
20221W103,2022,2022-04-01 05:12:35.952000,2022-04-01,312,2022-04-01 05:40:56.395658+00:00,340,-28
20221W103,2022,2022-04-02 05:08:50.384000,2022-04-02,308,2022-04-02 05:38:39.556442+00:00,338,-30
20221W103,2022,2022-04-03 05:06:09.346667,2022-04-03,306,2022-04-03 05:36:23.010883+00:00,336,-30
20221W103,2022,2022-04-04 05:16:14.506667,2022-04-04,316,2022-04-04 05:34:06.789754+00:00,334,-18
20221W103,2022,2022-04-05 05:08:20.373333,2022-04-05,308,2022-04-05 05:31:50.924057+00:00,331,-23
20221W103,2022,2022-04-06 05:01:06.456000,2022-04-06,301,2022-04-06 05:29:35.445039+00:00,329,-28
20221W103,2022,2022-04-07 04:59:11.781333,2022-04-07,299,2022-04-07 05:27:20.384224+00:00,327,-28
20221W103,2022,2022-04-08 04:52:31.512000,2022-04-08,292,2022-04-08 05:25:05.773430+00:00,325,-33
20221W103,2022,2022-04-09 04:57:32.680000,2022-04-09,297,2022-04-09 05:22:51.644800+00:00,322,-25
20221W103,2022,2022-04-10 05:11:44.013333,2022-04-10,311,2022-04-10 05:20:38.030821+00:00,320,-9
20221W103,2022,2022-04-11 04:50:14.528000,2022-04-11,290,2022-04-11 05:18:24.964349+00:00,318,-28
20221W103,2022,2022-04-12 04:58:11.904000,2022-04-12,298,2022-04-12 05:16:12.478629+00:00,316,-18
20221C16,2022,2022-04-12 04:58:38.988667,2022-04-12,298,2022-04-12 05:16:12.478629+00:00,316,-18
20221C16,2022,2022-04-13 04:50:56.200000,2022-04-13,290,2022-04-13 05:14:00.607320+00:00,314,-24
20221C160B,2022,2022-04-04 05:13:42.816000,2022-04-04,313,2022-04-04 05:34:06.789754+00:00,334,-21
20221C160B,2022,2022-04-05 05:01:41.400000,2022-04-05,301,2022-04-05 05:31:50.924057+00:00,331,-30
20221C160B,2022,2022-04-06 04:59:06.333333,2022-04-06,299,2022-04-06 05:29:35.445039+00:00,329,-30
20221C160B,2022,2022-04-07 04:57:39.968000,2022-04-07,297,2022-04-07 05:27:20.384224+00:00,327,-30
20221C160B,2022,2022-04-08 04:48:37.296000,2022-04-08,288,2022-04-08 05:25:05.773430+00:00,325,-37
20221C160B,2022,2022-04-09 04:49:58.416000,2022-04-09,289,2022-04-09 05:22:51.644800+00:00,322,-33
20221C163,2022,2022-04-15 04:34:26.400000,2022-04-15,274,2022-04-15 05:09:38.844755+00:00,309,-35
20221C163,2022,2022-04-16 05:30:41.877333,2022-04-16,330,2022-04-16 05:07:29.023067+00:00,307,23
20221C163,2022,2022-04-17 05:28:11.680000,2022-04-17,328,2022-04-17 05:05:19.954960+00:00,305,23
20221C20,2022,2022-04-02 05:58:03.053333,2022-04-02,358,2022-04-02 05:38:39.556442+00:00,338,20
20221C20,2022,2022-04-03 05:23:54.048000,2022-04-03,323,2022-04-03 05:36:23.010883+00:00,336,-13
20221C20,2022,2022-04-05 06:00:17.546667,2022-04-05,360,2022-04-05 05:31:50.924057+00:00,331,29
20221C20,2022,2022-04-06 05:32:55.128000,2022-04-06,332,2022-04-06 05:29:35.445039+00:00,329,3
20221C20,2022,2022-04-07 05:52:34.237333,2022-04-07,352,2022-04-07 05:27:20.384224+00:00,327,25
20221C20,2022,2022-04-08 05:38:55.018667,2022-04-08,338,2022-04-08 05:25:05.773430+00:00,325,13
20221C24C,2022,2022-04-05 05:13:15.840000,2022-04-05,313,2022-04-05 05:31:50.924057+00:00,331,-18
20221C24C,2022,2022-04-06 05:00:44.128000,2022-04-06,300,2022-04-06 05:29:35.445039+00:00,329,-29
20221C24C,2022,2022-04-07 04:59:43.536000,2022-04-07,299,2022-04-07 05:27:20.384224+00:00,327,-28
20221C24C,2022,2022-04-08 04:56:14.208000,2022-04-08,296,2022-04-08 05:25:05.773430+00:00,325,-29
20221C24C,2022,2022-04-09 04:52:09.037333,2022-04-09,292,2022-04-09 05:22:51.644800+00:00,322,-30
20221C24C,2022,2022-04-10 04:54:30.656000,2022-04-10,294,2022-04-10 05:20:38.030821+00:00,320,-26
20221C24C,2022,2022-04-11 04:56:08.448000,2022-04-11,296,2022-04-11 05:18:24.964349+00:00,318,-22
20221C24C,2022,2022-04-13 04:46:22.696000,2022-04-13,286,2022-04-13 05:14:00.607320+00:00,314,-28
20221C25,2022,2022-04-18 04:29:36.866667,2022-04-18,269,2022-04-18 05:03:11.676458+00:00,303,-34
20221C25,2022,2022-04-19 04:27:17.792000,2022-04-19,267,2022-04-19 05:01:04.224113+00:00,301,-34
20221C25,2022,2022-04-20 04:28:53.544000,2022-04-20,268,2022-04-20 04:58:57.635019+00:00,298,-30
20221C26,2022,2022-04-08 05:05:21.290667,2022-04-08,305,2022-04-08 05:25:05.773430+00:00,325,-20
20221C26,2022,2022-04-09 04:57:37.066667,2022-04-09,297,2022-04-09 05:22:51.644800+00:00,322,-25
20221C26,2022,2022-04-10 04:51:18.720000,2022-04-10,291,2022-04-10 05:20:38.030821+00:00,320,-29
20221C4,2022,2022-04-11 04:46:48.312000,2022-04-11,286,2022-04-11 05:18:24.964349+00:00,318,-32
20221C4,2022,2022-04-12 05:04:26.373333,2022-04-12,304,2022-04-12 05:16:12.478629+00:00,316,-12
20221C4,2022,2022-04-13 04:50:57.109333,2022-04-13,290,2022-04-13 05:14:00.607320+00:00,314,-24
20221C4,2022,2022-04-15 04:45:12.528000,2022-04-15,285,2022-04-15 05:09:38.844755+00:00,309,-24
20221C4,2022,2022-04-16 04:49:30.165333,2022-04-16,289,2022-04-16 05:07:29.023067+00:00,307,-18
20221C56,2022,2022-04-02 05:04:40.656000,2022-04-02,304,2022-04-02 05:38:39.556442+00:00,338,-34
20221C56,2022,2022-04-03 05:00:56.773333,2022-04-03,300,2022-04-03 05:36:23.010883+00:00,336,-36
20221C56,2022,2022-04-04 05:11:36.192000,2022-04-04,311,2022-04-04 05:34:06.789754+00:00,334,-23
20221C56,2022,2022-04-05 05:02:42.528000,2022-04-05,302,2022-04-05 05:31:50.924057+00:00,331,-29
20221C56,2022,2022-04-06 04:58:25.365333,2022-04-06,298,2022-04-06 05:29:35.445039+00:00,329,-31
20221C56,2022,2022-04-07 05:10:05.378667,2022-04-07,310,2022-04-07 05:27:20.384224+00:00,327,-17
20221C56,2022,2022-04-09 04:50:04.586667,2022-04-09,290,2022-04-09 05:22:51.644800+00:00,322,-32
20221C61A,2022,2022-04-10 04:48:48.170667,2022-04-10,288,2022-04-10 05:20:38.030821+00:00,320,-32
20221C61A,2022,2022-04-11 04:48:32.640000,2022-04-11,288,2022-04-11 05:18:24.964349+00:00,318,-30
20221C61A,2022,2022-04-12 04:53:28.128000,2022-04-12,293,2022-04-12 05:16:12.478629+00:00,316,-23
20221C62,2022,2022-04-03 05:09:56.000000,2022-04-03,309,2022-04-03 05:36:23.010883+00:00,336,-27
20221C62,2022,2022-04-05 05:15:20.133333,2022-04-05,315,2022-04-05 05:31:50.924057+00:00,331,-16
20221C62,2022,2022-04-06 05:10:00.512000,2022-04-06,310,2022-04-06 05:29:35.445039+00:00,329,-19
20221C62,2022,2022-04-07 05:10:11.456000,2022-04-07,310,2022-04-07 05:27:20.384224+00:00,327,-17
20221C62,2022,2022-04-08 05:03:00.674667,2022-04-08,303,2022-04-08 05:25:05.773430+00:00,325,-22
20221C62,2022,2022-04-09 04:58:05.504000,2022-04-09,298,2022-04-09 05:22:51.644800+00:00,322,-24
20221CP16,2022,2022-04-18 04:29:32.633333,2022-04-18,269,2022-04-18 05:03:11.676458+00:00,303,-34
20221CP16,2022,2022-04-19 04:29:30.900000,2022-04-19,269,2022-04-19 05:01:04.224113+00:00,301,-32
20221CP18,2022,2022-04-20 04:34:46.421333,2022-04-20,274,2022-04-20 04:58:57.635019+00:00,298,-24
20221O59,2022,2022-03-31 05:24:16.224000,2022-03-31,324,2022-03-31 05:43:13.497953+00:00,343,-19
20221O59,2022,2022-04-11 04:50:46.066667,2022-04-11,290,2022-04-11 05:18:24.964349+00:00,318,-28
20221O59,2022,2022-04-12 04:58:47.210667,2022-04-12,298,2022-04-12 05:16:12.478629+00:00,316,-18
20221O60,2022,2022-04-02 05:06:41.066667,2022-04-02,306,2022-04-02 05:38:39.556442+00:00,338,-32
20221O60,2022,2022-04-03 05:05:07.680000,2022-04-03,305,2022-04-03 05:36:23.010883+00:00,336,-31
20221O60,2022,2022-04-05 04:59:43.752000,2022-04-05,299,2022-04-05 05:31:50.924057+00:00,331,-32
20221O60,2022,2022-04-06 04:58:24.442667,2022-04-06,298,2022-04-06 05:29:35.445039+00:00,329,-31
20221O60,2022,2022-04-07 04:52:38.816000,2022-04-07,292,2022-04-07 05:27:20.384224+00:00,327,-35
20221O61,2022,2022-04-02 05:09:44.746667,2022-04-02,309,2022-04-02 05:38:39.556442+00:00,338,-29
20221O61,2022,2022-04-03 05:33:37.141333,2022-04-03,333,2022-04-03 05:36:23.010883+00:00,336,-3
20221O61,2022,2022-04-04 05:13:48.468000,2022-04-04,313,2022-04-04 05:34:06.789754+00:00,334,-21
20221O61,2022,2022-04-05 05:06:13.906667,2022-04-05,306,2022-04-05 05:31:50.924057+00:00,331,-25
20221O61,2022,2022-04-06 04:59:49.968000,2022-04-06,299,2022-04-06 05:29:35.445039+00:00,329,-30
20221O61,2022,2022-04-07 04:55:23.300000,2022-04-07,295,2022-04-07 05:27:20.384224+00:00,327,-32
20221O68,2022,2022-04-14 04:48:58.848000,2022-04-14,288,2022-04-14 05:11:49.384513+00:00,311,-23
20221O68,2022,2022-04-15 04:37:58.464000,2022-04-15,277,2022-04-15 05:09:38.844755+00:00,309,-32
20221O68,2022,2022-04-16 04:39:10.240000,2022-04-16,279,2022-04-16 05:07:29.023067+00:00,307,-28
20221O73,2022,2022-04-14 04:42:36.213333,2022-04-14,282,2022-04-14 05:11:49.384513+00:00,311,-29
20221O73,2022,2022-04-15 04:40:14.442667,2022-04-15,280,2022-04-15 05:09:38.844755+00:00,309,-29
20221O73,2022,2022-04-16 04:37:12.757333,2022-04-16,277,2022-04-16 05:07:29.023067+00:00,307,-30
20221O74,2022,2022-04-06 05:09:02.400000,2022-04-06,309,2022-04-06 05:29:35.445039+00:00,329,-20
20221O74,2022,2022-04-07 05:07:41.696000,2022-04-07,307,2022-04-07 05:27:20.384224+00:00,327,-20
20221O74,2022,2022-04-08 05:29:33.024000,2022-04-08,329,2022-04-08 05:25:05.773430+00:00,325,4
20221O75D,2022,2022-04-11 04:44:28.506667,2022-04-11,284,2022-04-11 05:18:24.964349+00:00,318,-34
20221O75D,2022,2022-04-13 04:41:26.933333,2022-04-13,281,2022-04-13 05:14:00.607320+00:00,314,-33
20221O78,2022,2022-04-20 04:35:00.192000,2022-04-20,275,2022-04-20 04:58:57.635019+00:00,298,-23
20221O78,2022,2022-04-21 04:27:45.066667,2022-04-21,267,2022-04-21 04:56:51.946833+00:00,296,-29
20221O78,2022,2022-04-22 04:31:18.904000,2022-04-22,271,2022-04-22 04:54:47.197779+00:00,294,-23
20221O78A,2022,2022-04-14 04:41:47.264000,2022-04-14,281,2022-04-14 05:11:49.384513+00:00,311,-30
20221O78A,2022,2022-04-15 04:39:58.933333,2022-04-15,279,2022-04-15 05:09:38.844755+00:00,309,-30
20221O78A,2022,2022-04-16 04:41:24.514667,2022-04-16,281,2022-04-16 05:07:29.023067+00:00,307,-26
20221O87,2022,2022-04-20 04:42:13.710667,2022-04-20,282,2022-04-20 04:58:57.635019+00:00,298,-16
20221P12,2022,2022-04-21 04:32:25.141333,2022-04-21,272,2022-04-21 04:56:51.946833+00:00,296,-24
20221P12,2022,2022-04-22 04:32:23.688000,2022-04-22,272,2022-04-22 04:54:47.197779+00:00,294,-22
20221P12,2022,2022-04-23 04:34:13.613333,2022-04-23,274,2022-04-23 04:52:43.426672+00:00,292,-18
20221P7,2022,2022-04-18 04:29:52.266667,2022-04-18,269,2022-04-18 05:03:11.676458+00:00,303,-34
20221P7,2022,2022-04-19 04:28:07.509333,2022-04-19,268,2022-04-19 05:01:04.224113+00:00,301,-33
20221P7,2022,2022-04-20 04:38:55.776000,2022-04-20,278,2022-04-20 04:58:57.635019+00:00,298,-20
20221SW1,2022,2022-04-10 04:48:37.445333,2022-04-10,288,2022-04-10 05:20:38.030821+00:00,320,-32
20221SW1,2022,2022-04-11 04:47:00.141333,2022-04-11,287,2022-04-11 05:18:24.964349+00:00,318,-31
20221SW1,2022,2022-04-12 04:57:55.005333,2022-04-12,297,2022-04-12 05:16:12.478629+00:00,316,-19
20221SW103,2022,2022-04-17 04:35:02.784000,2022-04-17,275,2022-04-17 05:05:19.954960+00:00,305,-30
20221SW103,2022,2022-04-18 04:34:19.136000,2022-04-18,274,2022-04-18 05:03:11.676458+00:00,303,-29
20221SW103,2022,2022-04-19 04:29:39.477333,2022-04-19,269,2022-04-19 05:01:04.224113+00:00,301,-32
20221EX2,2022,2022-04-11 04:46:12.008000,2022-04-11,286,2022-04-11 05:18:24.964349+00:00,318,-32
20221EX2,2022,2022-04-12 04:53:52.256000,2022-04-12,293,2022-04-12 05:16:12.478629+00:00,316,-23
20221EX2,2022,2022-04-13 04:45:52.026667,2022-04-13,285,2022-04-13 05:14:00.607320+00:00,314,-29
20221EX20,2022,2022-04-19 04:38:18.346667,2022-04-19,278,2022-04-19 05:01:04.224113+00:00,301,-23
20221EX21,2022,2022-04-14 04:44:30.084000,2022-04-14,284,2022-04-14 05:11:49.384513+00:00,311,-27
20221EX21,2022,2022-04-15 04:42:24.704000,2022-04-15,282,2022-04-15 05:09:38.844755+00:00,309,-27
20221EX21,2022,2022-04-17 04:40:00.346667,2022-04-17,280,2022-04-17 05:05:19.954960+00:00,305,-25
20221EX21,2022,2022-04-18 04:38:36.144000,2022-04-18,278,2022-04-18 05:03:11.676458+00:00,303,-25
20221EX22,2022,2022-04-06 04:56:31.680000,2022-04-06,296,2022-04-06 05:29:35.445039+00:00,329,-33
20221EX22,2022,2022-04-07 04:56:55.160000,2022-04-07,296,2022-04-07 05:27:20.384224+00:00,327,-31
20221EX22,2022,2022-04-08 04:59:03.661333,2022-04-08,299,2022-04-08 05:25:05.773430+00:00,325,-26
20221EX26,2022,2022-04-18 04:34:45.933333,2022-04-18,274,2022-04-18 05:03:11.676458+00:00,303,-29
20221EX26,2022,2022-04-19 04:37:48.432000,2022-04-19,277,2022-04-19 05:01:04.224113+00:00,301,-24
20221EX26,2022,2022-04-20 04:40:21.376000,2022-04-20,280,2022-04-20 04:58:57.635019+00:00,298,-18
20221EX34,2022,2022-04-06 05:00:47.254667,2022-04-06,300,2022-04-06 05:29:35.445039+00:00,329,-29
20221EX34,2022,2022-04-07 05:01:18.656000,2022-04-07,301,2022-04-07 05:27:20.384224+00:00,327,-26
20221EX34,2022,2022-04-08 05:02:04.777333,2022-04-08,302,2022-04-08 05:25:05.773430+00:00,325,-23
20221EX34,2022,2022-04-09 04:53:06.754667,2022-04-09,293,2022-04-09 05:22:51.644800+00:00,322,-29
20221EX34,2022,2022-04-10 04:56:09.688000,2022-04-10,296,2022-04-10 05:20:38.030821+00:00,320,-24
20221EX34,2022,2022-04-11 05:00:12.373333,2022-04-11,300,2022-04-11 05:18:24.964349+00:00,318,-18
20221EX38,2022,2022-04-23 04:27:54.936000,2022-04-23,267,2022-04-23 04:52:43.426672+00:00,292,-25
20221EX38,2022,2022-04-24 04:22:34.480000,2022-04-24,262,2022-04-24 04:50:40.672918+00:00,290,-28
20221EX38,2022,2022-04-25 04:22:39.445333,2022-04-25,262,2022-04-25 04:48:38.976532+00:00,288,-26
20221EX40,2022,2022-04-17 04:36:38.965333,2022-04-17,276,2022-04-17 05:05:19.954960+00:00,305,-29
20221EX40,2022,2022-04-18 04:35:16.389333,2022-04-18,275,2022-04-18 05:03:11.676458+00:00,303,-28
20221EX41,2022,2022-04-16 04:39:32.512000,2022-04-16,279,2022-04-16 05:07:29.023067+00:00,307,-28
20221EX41,2022,2022-04-17 04:33:44.586667,2022-04-17,273,2022-04-17 05:05:19.954960+00:00,305,-32
20221EX41,2022,2022-04-18 04:38:01.664000,2022-04-18,278,2022-04-18 05:03:11.676458+00:00,303,-25
20221EX43,2022,2022-04-17 04:34:05.906667,2022-04-17,274,2022-04-17 05:05:19.954960+00:00,305,-31
20221EX43,2022,2022-04-18 04:36:04.520000,2022-04-18,276,2022-04-18 05:03:11.676458+00:00,303,-27
20221EX55,2022,2022-04-06 05:02:59.328000,2022-04-06,302,2022-04-06 05:29:35.445039+00:00,329,-27
20221EX55,2022,2022-04-07 04:54:46.253333,2022-04-07,294,2022-04-07 05:27:20.384224+00:00,327,-33
20221EX55,2022,2022-04-08 04:52:34.784000,2022-04-08,292,2022-04-08 05:25:05.773430+00:00,325,-33
20221EX55,2022,2022-04-09 04:50:13.693333,2022-04-09,290,2022-04-09 05:22:51.644800+00:00,322,-32
20221EX55,2022,2022-04-10 04:48:05.784000,2022-04-10,288,2022-04-10 05:20:38.030821+00:00,320,-32
20221EX55,2022,2022-04-11 04:50:06.944000,2022-04-11,290,2022-04-11 05:18:24.964349+00:00,318,-28
20221EX55,2022,2022-04-13 04:41:44.672000,2022-04-13,281,2022-04-13 05:14:00.607320+00:00,314,-33
20221EX55,2022,2022-04-14 04:41:09.872000,2022-04-14,281,2022-04-14 05:11:49.384513+00:00,311,-30
20221EX55,2022,2022-04-15 04:35:52.546667,2022-04-15,275,2022-04-15 05:09:38.844755+00:00,309,-34
20221EX59,2022,2022-04-23 04:24:16.085333,2022-04-23,264,2022-04-23 04:52:43.426672+00:00,292,-28
20221EX59,2022,2022-04-24 04:22:39.813333,2022-04-24,262,2022-04-24 04:50:40.672918+00:00,290,-28
20221EX59,2022,2022-04-25 04:26:56.736000,2022-04-25,266,2022-04-25 04:48:38.976532+00:00,288,-22
20221EX60,2022,2022-04-15 04:44:31.760000,2022-04-15,284,2022-04-15 05:09:38.844755+00:00,309,-25
20221EX60,2022,2022-04-16 04:35:35.748000,2022-04-16,275,2022-04-16 05:07:29.023067+00:00,307,-32
20221EX60,2022,2022-04-17 04:41:38.560000,2022-04-17,281,2022-04-17 05:05:19.954960+00:00,305,-24
20221EX62,2022,2022-04-21 04:26:19.200000,2022-04-21,266,2022-04-21 04:56:51.946833+00:00,296,-30
20221EX62,2022,2022-04-22 04:40:36.912000,2022-04-22,280,2022-04-22 04:54:47.197779+00:00,294,-14
20221EX62,2022,2022-04-23 04:30:26.944000,2022-04-23,270,2022-04-23 04:52:43.426672+00:00,292,-22
20221EX62B,2022,2022-05-03 05:02:31.610667,2022-05-03,302,2022-05-03 04:33:08.477034+00:00,273,29
20221EX62B,2022,2022-05-04 05:24:49.450667,2022-05-04,324,2022-05-04 04:31:18.200067+00:00,271,53
20221EX62C,2022,2022-04-19 04:28:48.896000,2022-04-19,268,2022-04-19 05:01:04.224113+00:00,301,-33
20221EX62C,2022,2022-04-20 04:37:03.069333,2022-04-20,277,2022-04-20 04:58:57.635019+00:00,298,-21
20221EX62C,2022,2022-04-21 04:29:15.786667,2022-04-21,269,2022-04-21 04:56:51.946833+00:00,296,-27
20221EX62E,2022,2022-04-19 04:24:30.846667,2022-04-19,264,2022-04-19 05:01:04.224113+00:00,301,-37
20221EX62E,2022,2022-04-20 04:27:21.876000,2022-04-20,267,2022-04-20 04:58:57.635019+00:00,298,-31
20221EX62E,2022,2022-04-21 04:21:48.272000,2022-04-21,261,2022-04-21 04:56:51.946833+00:00,296,-35
20221EX62G,2022,2022-04-19 04:20:54.240000,2022-04-19,260,2022-04-19 05:01:04.224113+00:00,301,-41
20221EX62G,2022,2022-04-20 04:30:14.176000,2022-04-20,270,2022-04-20 04:58:57.635019+00:00,298,-28
20221EX62G,2022,2022-04-21 04:22:19.296000,2022-04-21,262,2022-04-21 04:56:51.946833+00:00,296,-34
20221MP42,2022,2022-04-14 04:46:00.768000,2022-04-14,286,2022-04-14 05:11:49.384513+00:00,311,-25
20221MP42,2022,2022-04-15 04:39:32.480000,2022-04-15,279,2022-04-15 05:09:38.844755+00:00,309,-30
20221MP42,2022,2022-04-16 04:41:25.984000,2022-04-16,281,2022-04-16 05:07:29.023067+00:00,307,-26
20221MP49,2022,2022-04-20 04:39:28.762667,2022-04-20,279,2022-04-20 04:58:57.635019+00:00,298,-19
20221MP49,2022,2022-04-21 04:48:59.349333,2022-04-21,288,2022-04-21 04:56:51.946833+00:00,296,-8
20221MP49,2022,2022-04-22 05:10:40.960000,2022-04-22,310,2022-04-22 04:54:47.197779+00:00,294,16
20221MP55,2022,2022-04-09 04:54:30.222667,2022-04-09,294,2022-04-09 05:22:51.644800+00:00,322,-28
20221MP55,2022,2022-04-10 04:49:20.576000,2022-04-10,289,2022-04-10 05:20:38.030821+00:00,320,-31
20221MP55,2022,2022-04-11 04:47:58.954667,2022-04-11,287,2022-04-11 05:18:24.964349+00:00,318,-31
20221MP55,2022,2022-04-13 04:46:54.933333,2022-04-13,286,2022-04-13 05:14:00.607320+00:00,314,-28
20221MP55,2022,2022-04-14 04:42:02.144000,2022-04-14,282,2022-04-14 05:11:49.384513+00:00,311,-29
20221MP56,2022,2022-04-01 05:43:59.804000,2022-04-01,343,2022-04-01 05:40:56.395658+00:00,340,3
20221MP56,2022,2022-04-02 05:33:56.544000,2022-04-02,333,2022-04-02 05:38:39.556442+00:00,338,-5
20221MP56,2022,2022-04-03 05:32:08.528000,2022-04-03,332,2022-04-03 05:36:23.010883+00:00,336,-4
20221MP56,2022,2022-04-05 05:06:33.920000,2022-04-05,306,2022-04-05 05:31:50.924057+00:00,331,-25
20221MP56,2022,2022-04-06 05:05:16.800000,2022-04-06,305,2022-04-06 05:29:35.445039+00:00,329,-24
20221MP56,2022,2022-04-07 05:19:38.997333,2022-04-07,319,2022-04-07 05:27:20.384224+00:00,327,-8
20221MP56,2022,2022-04-08 05:20:11.221333,2022-04-08,320,2022-04-08 05:25:05.773430+00:00,325,-5
20221MP58,2022,2022-04-15 05:00:04.644000,2022-04-15,300,2022-04-15 05:09:38.844755+00:00,309,-9
20221MP58,2022,2022-04-16 04:59:21.546667,2022-04-16,299,2022-04-16 05:07:29.023067+00:00,307,-8
20221MP58,2022,2022-04-17 04:39:26.252000,2022-04-17,279,2022-04-17 05:05:19.954960+00:00,305,-26
20221MP58,2022,2022-04-18 04:45:42.570667,2022-04-18,285,2022-04-18 05:03:11.676458+00:00,303,-18
20221MP58,2022,2022-04-19 04:37:18.058667,2022-04-19,277,2022-04-19 05:01:04.224113+00:00,301,-24
20221MP63,2022,2022-04-12 04:55:55.200000,2022-04-12,295,2022-04-12 05:16:12.478629+00:00,316,-21
20221MP63,2022,2022-04-13 04:44:23.696000,2022-04-13,284,2022-04-13 05:14:00.607320+00:00,314,-30
20221MP63,2022,2022-04-14 04:38:39.594667,2022-04-14,278,2022-04-14 05:11:49.384513+00:00,311,-33
20221MP65,2022,2022-04-14 04:40:04.714667,2022-04-14,280,2022-04-14 05:11:49.384513+00:00,311,-31
20221MP65,2022,2022-04-15 04:39:12.216000,2022-04-15,279,2022-04-15 05:09:38.844755+00:00,309,-30
20221MP65,2022,2022-04-16 04:45:28.106667,2022-04-16,285,2022-04-16 05:07:29.023067+00:00,307,-22
20221MP69,2022,2022-04-09 04:58:11.413333,2022-04-09,298,2022-04-09 05:22:51.644800+00:00,322,-24
20221MP69,2022,2022-04-10 04:53:23.882667,2022-04-10,293,2022-04-10 05:20:38.030821+00:00,320,-27
20221MP69,2022,2022-04-11 04:54:59.328000,2022-04-11,294,2022-04-11 05:18:24.964349+00:00,318,-24
20221MP74,2022,2022-04-10 04:48:55.253333,2022-04-10,288,2022-04-10 05:20:38.030821+00:00,320,-32
20221MP74,2022,2022-04-11 04:47:16.138667,2022-04-11,287,2022-04-11 05:18:24.964349+00:00,318,-31
20221MP74,2022,2022-04-12 04:50:35.050667,2022-04-12,290,2022-04-12 05:16:12.478629+00:00,316,-26
20221MP74,2022,2022-04-13 04:42:51.050667,2022-04-13,282,2022-04-13 05:14:00.607320+00:00,314,-32
20221MP74,2022,2022-04-14 04:37:16.800000,2022-04-14,277,2022-04-14 05:11:49.384513+00:00,311,-34
20221MP76,2022,2022-04-09 04:59:00.746667,2022-04-09,299,2022-04-09 05:22:51.644800+00:00,322,-23
20221MP76,2022,2022-04-10 04:48:59.613333,2022-04-10,288,2022-04-10 05:20:38.030821+00:00,320,-32
20221MP76,2022,2022-04-11 04:47:56.786667,2022-04-11,287,2022-04-11 05:18:24.964349+00:00,318,-31
20221MP76,2022,2022-04-12 05:25:38.466667,2022-04-12,325,2022-04-12 05:16:12.478629+00:00,316,9
20221MP76,2022,2022-04-13 04:44:28.368000,2022-04-13,284,2022-04-13 05:14:00.607320+00:00,314,-30
20221MP76,2022,2022-04-14 04:31:20.134667,2022-04-14,271,2022-04-14 05:11:49.384513+00:00,311,-40
20221MP77,2022,2022-04-05 05:23:17.120000,2022-04-05,323,2022-04-05 05:31:50.924057+00:00,331,-8
20221MP79,2022,2022-04-11 04:50:17.568000,2022-04-11,290,2022-04-11 05:18:24.964349+00:00,318,-28
20221MP79,2022,2022-04-12 04:58:59.936000,2022-04-12,298,2022-04-12 05:16:12.478629+00:00,316,-18
20221MP79,2022,2022-04-13 04:46:52.224000,2022-04-13,286,2022-04-13 05:14:00.607320+00:00,314,-28
20221MP79,2022,2022-04-14 04:44:27.440000,2022-04-14,284,2022-04-14 05:11:49.384513+00:00,311,-27
20221MP89,2022,2022-04-19 04:37:01.813333,2022-04-19,277,2022-04-19 05:01:04.224113+00:00,301,-24
20221MP89,2022,2022-04-20 04:39:43.360000,2022-04-20,279,2022-04-20 04:58:57.635019+00:00,298,-19
20221MP89,2022,2022-04-21 04:43:52.192000,2022-04-21,283,2022-04-21 04:56:51.946833+00:00,296,-13
20221MP92,2022,2022-04-22 04:29:04.384000,2022-04-22,269,2022-04-22 04:54:47.197779+00:00,294,-25
20221MP92,2022,2022-04-23 04:25:02.112000,2022-04-23,265,2022-04-23 04:52:43.426672+00:00,292,-27
20221MP92,2022,2022-04-24 04:21:04.480000,2022-04-24,261,2022-04-24 04:50:40.672918+00:00,290,-29
20221MP96,2022,2022-04-22 05:37:06.602667,2022-04-22,337,2022-04-22 04:54:47.197779+00:00,294,43
20221MP96,2022,2022-04-23 04:49:45.429333,2022-04-23,289,2022-04-23 04:52:43.426672+00:00,292,-3
20221MP96,2022,2022-04-24 05:16:33.706667,2022-04-24,316,2022-04-24 04:50:40.672918+00:00,290,26
20221MP97,2022,2022-04-22 04:30:12.032000,2022-04-22,270,2022-04-22 04:54:47.197779+00:00,294,-24
20221MP97,2022,2022-04-23 04:49:31.669333,2022-04-23,289,2022-04-23 04:52:43.426672+00:00,292,-3
20221C107,2022,2022-04-15 04:37:12.096000,2022-04-15,277,2022-04-15 05:09:38.844755+00:00,309,-32
20221C107,2022,2022-04-16 04:33:36.597333,2022-04-16,273,2022-04-16 05:07:29.023067+00:00,307,-34
20221C107,2022,2022-04-17 04:32:47.616000,2022-04-17,272,2022-04-17 05:05:19.954960+00:00,305,-33
20221C115,2022,2022-04-08 04:54:54.218667,2022-04-08,294,2022-04-08 05:25:05.773430+00:00,325,-31
20221C115,2022,2022-04-09 04:49:26.133333,2022-04-09,289,2022-04-09 05:22:51.644800+00:00,322,-33
20221C115,2022,2022-04-10 04:48:24.533333,2022-04-10,288,2022-04-10 05:20:38.030821+00:00,320,-32
20221C115,2022,2022-04-12 05:17:28.608000,2022-04-12,317,2022-04-12 05:16:12.478629+00:00,316,1
20221C115,2022,2022-04-13 04:50:49.216000,2022-04-13,290,2022-04-13 05:14:00.607320+00:00,314,-24
20221C118,2022,2022-04-08 04:52:46.872000,2022-04-08,292,2022-04-08 05:25:05.773430+00:00,325,-33
20221C118,2022,2022-04-10 04:44:25.493333,2022-04-10,284,2022-04-10 05:20:38.030821+00:00,320,-36
20221C118,2022,2022-04-11 04:44:07.754667,2022-04-11,284,2022-04-11 05:18:24.964349+00:00,318,-34
20221C118,2022,2022-04-12 04:53:12.832000,2022-04-12,293,2022-04-12 05:16:12.478629+00:00,316,-23
20221C118,2022,2022-04-13 04:43:42.986667,2022-04-13,283,2022-04-13 05:14:00.607320+00:00,314,-31
20221C148,2022,2022-04-02 05:08:30.448000,2022-04-02,308,2022-04-02 05:38:39.556442+00:00,338,-30
20221C148,2022,2022-04-03 05:03:36.096000,2022-04-03,303,2022-04-03 05:36:23.010883+00:00,336,-33
20221C148,2022,2022-04-04 05:12:16.800000,2022-04-04,312,2022-04-04 05:34:06.789754+00:00,334,-22
20221C148,2022,2022-04-05 05:07:29.216000,2022-04-05,307,2022-04-05 05:31:50.924057+00:00,331,-24
20221C148,2022,2022-04-06 05:01:17.214667,2022-04-06,301,2022-04-06 05:29:35.445039+00:00,329,-28
20221C148,2022,2022-04-07 04:58:13.664000,2022-04-07,298,2022-04-07 05:27:20.384224+00:00,327,-29
20221C151,2022,2022-04-14 04:34:27.288000,2022-04-14,274,2022-04-14 05:11:49.384513+00:00,311,-37
20221C151,2022,2022-04-15 04:33:57.048000,2022-04-15,273,2022-04-15 05:09:38.844755+00:00,309,-36
20221C151,2022,2022-04-16 04:32:22.490667,2022-04-16,272,2022-04-16 05:07:29.023067+00:00,307,-35
20221C152,2022,2022-04-01 05:07:06.122667,2022-04-01,307,2022-04-01 05:40:56.395658+00:00,340,-33
20221C152,2022,2022-04-02 05:05:56.981333,2022-04-02,305,2022-04-02 05:38:39.556442+00:00,338,-33
20221C152,2022,2022-04-03 05:09:56.544000,2022-04-03,309,2022-04-03 05:36:23.010883+00:00,336,-27
20221C152,2022,2022-04-04 05:18:19.690667,2022-04-04,318,2022-04-04 05:34:06.789754+00:00,334,-16
20221C152,2022,2022-04-05 05:04:54.709333,2022-04-05,304,2022-04-05 05:31:50.924057+00:00,331,-27
20221C152,2022,2022-04-06 04:58:03.968000,2022-04-06,298,2022-04-06 05:29:35.445039+00:00,329,-31
20221C152,2022,2022-04-07 04:53:50.688000,2022-04-07,293,2022-04-07 05:27:20.384224+00:00,327,-34
20221C152,2022,2022-04-08 04:48:58.736000,2022-04-08,288,2022-04-08 05:25:05.773430+00:00,325,-37
20221C152,2022,2022-04-09 04:43:38.952000,2022-04-09,283,2022-04-09 05:22:51.644800+00:00,322,-39
20221C153,2022,2022-04-16 05:07:16.949333,2022-04-16,307,2022-04-16 05:07:29.023067+00:00,307,0
20221C153,2022,2022-04-17 05:07:22.853333,2022-04-17,307,2022-04-17 05:05:19.954960+00:00,305,2
20221B217,2022,2022-04-27 04:23:14.626667,2022-04-27,263,2022-04-27 04:44:38.918999+00:00,284,-21
20221B224,2022,2022-04-18 04:24:22.473333,2022-04-18,264,2022-04-18 05:03:11.676458+00:00,303,-39
20221B224,2022,2022-04-19 04:24:32.034667,2022-04-19,264,2022-04-19 05:01:04.224113+00:00,301,-37
20221B224,2022,2022-04-20 04:29:47.658667,2022-04-20,269,2022-04-20 04:58:57.635019+00:00,298,-29
20221B31,2022,2022-04-13 04:42:29.245333,2022-04-13,282,2022-04-13 05:14:00.607320+00:00,314,-32
20221B31,2022,2022-04-14 04:39:45.753333,2022-04-14,279,2022-04-14 05:11:49.384513+00:00,311,-32
20221B31,2022,2022-04-15 04:49:41.583333,2022-04-15,289,2022-04-15 05:09:38.844755+00:00,309,-20
20221B31,2022,2022-04-17 04:47:51.493333,2022-04-17,287,2022-04-17 05:05:19.954960+00:00,305,-18
20221B31,2022,2022-04-18 04:40:56.800000,2022-04-18,280,2022-04-18 05:03:11.676458+00:00,303,-23
20221B31,2022,2022-04-19 04:33:27.360000,2022-04-19,273,2022-04-19 05:01:04.224113+00:00,301,-28
20221B32,2022,2022-04-27 04:18:50.016000,2022-04-27,258,2022-04-27 04:44:38.918999+00:00,284,-26
20221B32,2022,2022-04-28 04:19:49.898667,2022-04-28,259,2022-04-28 04:42:40.640973+00:00,282,-23
20221B32,2022,2022-04-29 04:15:15.077333,2022-04-29,255,2022-04-29 04:40:43.586566+00:00,280,-25
20221B32,2022,2022-04-30 04:12:04.946667,2022-04-30,252,2022-04-30 04:38:47.798905+00:00,278,-26
20221B32,2022,2022-05-02 04:12:01.392000,2022-05-02,252,2022-05-02 04:35:00.199457+00:00,275,-23
20221B36,2022,2022-04-16 04:40:30.058667,2022-04-16,280,2022-04-16 05:07:29.023067+00:00,307,-27
20221B36,2022,2022-04-17 04:31:08.820000,2022-04-17,271,2022-04-17 05:05:19.954960+00:00,305,-34
20221B43,2022,2022-04-12 04:56:12.058667,2022-04-12,296,2022-04-12 05:16:12.478629+00:00,316,-20
20221B43,2022,2022-04-13 04:45:44.784000,2022-04-13,285,2022-04-13 05:14:00.607320+00:00,314,-29
20221B43,2022,2022-04-14 04:41:30.272000,2022-04-14,281,2022-04-14 05:11:49.384513+00:00,311,-30
20221B44,2022,2022-04-21 04:33:51.573333,2022-04-21,273,2022-04-21 04:56:51.946833+00:00,296,-23
20221B44,2022,2022-04-22 04:39:51.946667,2022-04-22,279,2022-04-22 04:54:47.197779+00:00,294,-15
20221B44,2022,2022-04-23 04:51:36.917333,2022-04-23,291,2022-04-23 04:52:43.426672+00:00,292,-1
20221B49,2022,2022-04-15 04:40:56.746667,2022-04-15,280,2022-04-15 05:09:38.844755+00:00,309,-29
20221B49,2022,2022-04-16 04:35:07.093333,2022-04-16,275,2022-04-16 05:07:29.023067+00:00,307,-32
20221B49,2022,2022-04-17 04:29:38.074667,2022-04-17,269,2022-04-17 05:05:19.954960+00:00,305,-36
20221B65,2022,2022-04-21 04:29:55.193333,2022-04-21,269,2022-04-21 04:56:51.946833+00:00,296,-27
20221B65,2022,2022-04-22 04:31:36.626667,2022-04-22,271,2022-04-22 04:54:47.197779+00:00,294,-23
20221B65,2022,2022-04-23 04:35:23.650667,2022-04-23,275,2022-04-23 04:52:43.426672+00:00,292,-17
20221B65,2022,2022-04-24 04:27:16.192000,2022-04-24,267,2022-04-24 04:50:40.672918+00:00,290,-23
20221B65,2022,2022-04-25 04:25:15.200000,2022-04-25,265,2022-04-25 04:48:38.976532+00:00,288,-23
20221B65,2022,2022-04-26 04:31:33.136000,2022-04-26,271,2022-04-26 04:46:38.378143+00:00,286,-15
20221B78,2022,2022-04-22 04:24:56.320000,2022-04-22,264,2022-04-22 04:54:47.197779+00:00,294,-30
20221B78,2022,2022-04-23 04:25:40.373333,2022-04-23,265,2022-04-23 04:52:43.426672+00:00,292,-27
20221B78,2022,2022-04-24 04:23:19.914667,2022-04-24,263,2022-04-24 04:50:40.672918+00:00,290,-27
20221B98,2022,2022-04-13 04:43:12.960000,2022-04-13,283,2022-04-13 05:14:00.607320+00:00,314,-31
20221B98,2022,2022-04-14 04:34:29.610667,2022-04-14,274,2022-04-14 05:11:49.384513+00:00,311,-37
20221B98,2022,2022-04-15 04:32:55.498667,2022-04-15,272,2022-04-15 05:09:38.844755+00:00,309,-37
20221EX64,2022,2022-04-19 04:21:26.086667,2022-04-19,261,2022-04-19 05:01:04.224113+00:00,301,-40
20221EX64,2022,2022-04-20 04:34:49.552000,2022-04-20,274,2022-04-20 04:58:57.635019+00:00,298,-24
20221EX78,2022,2022-04-16 04:33:19.584000,2022-04-16,273,2022-04-16 05:07:29.023067+00:00,307,-34
20221EX78,2022,2022-04-17 04:28:02.248000,2022-04-17,268,2022-04-17 05:05:19.954960+00:00,305,-37
20221EX78,2022,2022-04-18 04:28:03.973333,2022-04-18,268,2022-04-18 05:03:11.676458+00:00,303,-35
20221EX86,2022,2022-04-20 04:27:09.404000,2022-04-20,267,2022-04-20 04:58:57.635019+00:00,298,-31
20221EX86,2022,2022-04-21 04:23:12.400000,2022-04-21,263,2022-04-21 04:56:51.946833+00:00,296,-33
20221EX86,2022,2022-04-22 04:25:07.865333,2022-04-22,265,2022-04-22 04:54:47.197779+00:00,294,-29
20221EX86,2022,2022-04-23 04:24:07.926667,2022-04-23,264,2022-04-23 04:52:43.426672+00:00,292,-28
20221EX86,2022,2022-04-24 04:21:24.160000,2022-04-24,261,2022-04-24 04:50:40.672918+00:00,290,-29
20221EX86,2022,2022-04-25 04:19:00.552000,2022-04-25,259,2022-04-25 04:48:38.976532+00:00,288,-29
20221EX86,2022,2022-04-26 04:21:06.682667,2022-04-26,261,2022-04-26 04:46:38.378143+00:00,286,-25
20221EX86,2022,2022-04-27 04:17:40.266667,2022-04-27,257,2022-04-27 04:44:38.918999+00:00,284,-27
20221EX86,2022,2022-04-28 04:18:00.800000,2022-04-28,258,2022-04-28 04:42:40.640973+00:00,282,-24
20221EX86,2022,2022-04-29 04:18:06.752000,2022-04-29,258,2022-04-29 04:40:43.586566+00:00,280,-22
20221EX86,2022,2022-04-30 04:11:44.088000,2022-04-30,251,2022-04-30 04:38:47.798905+00:00,278,-27
20221EX86,2022,2022-05-01 04:16:30.080000,2022-05-01,256,2022-05-01 04:36:53.321744+00:00,276,-20
20221MP11,2022,2022-04-16 04:39:58.256000,2022-04-16,279,2022-04-16 05:07:29.023067+00:00,307,-28
20221MP11,2022,2022-04-17 04:43:52.874667,2022-04-17,283,2022-04-17 05:05:19.954960+00:00,305,-22
20221MP11,2022,2022-04-18 04:44:11.936000,2022-04-18,284,2022-04-18 05:03:11.676458+00:00,303,-19
20221MP17,2022,2022-04-14 04:37:24.534000,2022-04-14,277,2022-04-14 05:11:49.384513+00:00,311,-34
20221MP17,2022,2022-04-15 04:29:30.293333,2022-04-15,269,2022-04-15 05:09:38.844755+00:00,309,-40
20221MP17,2022,2022-04-16 04:33:29.765333,2022-04-16,273,2022-04-16 05:07:29.023067+00:00,307,-34
20221MP20,2022,2022-04-16 04:34:04.480000,2022-04-16,274,2022-04-16 05:07:29.023067+00:00,307,-33
20221MP20,2022,2022-04-17 04:34:14.352000,2022-04-17,274,2022-04-17 05:05:19.954960+00:00,305,-31
20221MP20,2022,2022-04-18 04:27:14.453333,2022-04-18,267,2022-04-18 05:03:11.676458+00:00,303,-36
20221MP27,2022,2022-04-09 04:42:08.381333,2022-04-09,282,2022-04-09 05:22:51.644800+00:00,322,-40
20221MP27,2022,2022-04-11 04:46:22.304000,2022-04-11,286,2022-04-11 05:18:24.964349+00:00,318,-32
20221MP27,2022,2022-04-12 04:57:19.402667,2022-04-12,297,2022-04-12 05:16:12.478629+00:00,316,-19
20221MP27,2022,2022-04-13 04:48:33.184000,2022-04-13,288,2022-04-13 05:14:00.607320+00:00,314,-26
20221MP27,2022,2022-04-14 04:49:59.574667,2022-04-14,289,2022-04-14 05:11:49.384513+00:00,311,-22
20221MP27,2022,2022-04-16 05:08:53.400000,2022-04-16,308,2022-04-16 05:07:29.023067+00:00,307,1
20221MP27,2022,2022-04-17 05:03:09.813333,2022-04-17,303,2022-04-17 05:05:19.954960+00:00,305,-2
20221MP27,2022,2022-04-18 04:31:08.617333,2022-04-18,271,2022-04-18 05:03:11.676458+00:00,303,-32
20221MP32,2022,2022-04-09 05:05:32.800000,2022-04-09,305,2022-04-09 05:22:51.644800+00:00,322,-17
20221MP32,2022,2022-04-10 04:46:37.209333,2022-04-10,286,2022-04-10 05:20:38.030821+00:00,320,-34
20221MP32,2022,2022-04-11 04:57:52.446000,2022-04-11,297,2022-04-11 05:18:24.964349+00:00,318,-21
20221MP32,2022,2022-04-12 04:57:05.872000,2022-04-12,297,2022-04-12 05:16:12.478629+00:00,316,-19
20221MP32,2022,2022-04-13 04:48:45.704000,2022-04-13,288,2022-04-13 05:14:00.607320+00:00,314,-26
20221MP32,2022,2022-04-14 04:37:03.328000,2022-04-14,277,2022-04-14 05:11:49.384513+00:00,311,-34
20221MP34A,2022,2022-04-19 05:03:52.810667,2022-04-19,303,2022-04-19 05:01:04.224113+00:00,301,2
20221MP34A,2022,2022-04-21 04:31:20.138667,2022-04-21,271,2022-04-21 04:56:51.946833+00:00,296,-25
20221MP38,2022,2022-04-16 04:36:21.418667,2022-04-16,276,2022-04-16 05:07:29.023067+00:00,307,-31
20221MP38,2022,2022-04-17 05:11:38.413333,2022-04-17,311,2022-04-17 05:05:19.954960+00:00,305,6
20221MP38,2022,2022-04-18 05:11:15.800000,2022-04-18,311,2022-04-18 05:03:11.676458+00:00,303,8
20221W104,2022,2022-04-14 04:40:33.306667,2022-04-14,280,2022-04-14 05:11:49.384513+00:00,311,-31
20221W104,2022,2022-04-16 04:34:09.960000,2022-04-16,274,2022-04-16 05:07:29.023067+00:00,307,-33
20221W17,2022,2022-04-18 04:30:16.968000,2022-04-18,270,2022-04-18 05:03:11.676458+00:00,303,-33
20221W17,2022,2022-04-19 04:27:34.421333,2022-04-19,267,2022-04-19 05:01:04.224113+00:00,301,-34
20221W17,2022,2022-04-20 04:35:05.066667,2022-04-20,275,2022-04-20 04:58:57.635019+00:00,298,-23
20221W25,2022,2022-04-09 05:03:19.658667,2022-04-09,303,2022-04-09 05:22:51.644800+00:00,322,-19
20221W25,2022,2022-04-10 04:57:48.202667,2022-04-10,297,2022-04-10 05:20:38.030821+00:00,320,-23
20221W25,2022,2022-04-11 04:58:42.613333,2022-04-11,298,2022-04-11 05:18:24.964349+00:00,318,-20
20221W25,2022,2022-04-12 04:57:57.072000,2022-04-12,297,2022-04-12 05:16:12.478629+00:00,316,-19
20221W25,2022,2022-04-13 04:48:33.185333,2022-04-13,288,2022-04-13 05:14:00.607320+00:00,314,-26
20221W25,2022,2022-04-14 04:44:52.960000,2022-04-14,284,2022-04-14 05:11:49.384513+00:00,311,-27
20221W29,2022,2022-04-25 04:21:17.856000,2022-04-25,261,2022-04-25 04:48:38.976532+00:00,288,-27
20221W29,2022,2022-04-26 04:43:58.976000,2022-04-26,283,2022-04-26 04:46:38.378143+00:00,286,-3
20221W29,2022,2022-04-27 04:34:43.797333,2022-04-27,274,2022-04-27 04:44:38.918999+00:00,284,-10
20221W29,2022,2022-04-28 04:33:36.362667,2022-04-28,273,2022-04-28 04:42:40.640973+00:00,282,-9
20221W29,2022,2022-05-01 04:46:50.826667,2022-05-01,286,2022-05-01 04:36:53.321744+00:00,276,10
20221W33,2022,2022-04-15 04:36:19.128000,2022-04-15,276,2022-04-15 05:09:38.844755+00:00,309,-33
20221W33,2022,2022-04-16 04:40:37.066667,2022-04-16,280,2022-04-16 05:07:29.023067+00:00,307,-27
20221W33,2022,2022-04-17 04:32:30.378667,2022-04-17,272,2022-04-17 05:05:19.954960+00:00,305,-33
20221W35,2022,2022-04-09 05:01:32.736000,2022-04-09,301,2022-04-09 05:22:51.644800+00:00,322,-21
20221W35,2022,2022-04-10 04:49:55.584000,2022-04-10,289,2022-04-10 05:20:38.030821+00:00,320,-31
20221W35,2022,2022-04-11 04:54:23.138667,2022-04-11,294,2022-04-11 05:18:24.964349+00:00,318,-24
20221W49,2022,2022-04-01 05:12:47.712000,2022-04-01,312,2022-04-01 05:40:56.395658+00:00,340,-28
20221W49,2022,2022-04-02 05:16:49.664000,2022-04-02,316,2022-04-02 05:38:39.556442+00:00,338,-22
20221W5,2022,2022-04-18 04:22:53.200000,2022-04-18,262,2022-04-18 05:03:11.676458+00:00,303,-41
20221W5,2022,2022-04-19 04:29:29.946667,2022-04-19,269,2022-04-19 05:01:04.224113+00:00,301,-32
20221W5,2022,2022-04-20 04:31:16.298667,2022-04-20,271,2022-04-20 04:58:57.635019+00:00,298,-27
20221W64A,2022,2022-04-01 05:11:13.194667,2022-04-01,311,2022-04-01 05:40:56.395658+00:00,340,-29
20221W64A,2022,2022-04-03 05:07:13.152000,2022-04-03,307,2022-04-03 05:36:23.010883+00:00,336,-29
20221W64A,2022,2022-04-07 04:54:56.906667,2022-04-07,294,2022-04-07 05:27:20.384224+00:00,327,-33
20221W64A,2022,2022-04-08 04:52:59.946667,2022-04-08,292,2022-04-08 05:25:05.773430+00:00,325,-33
20221W67,2022,2022-04-08 04:52:51.216000,2022-04-08,292,2022-04-08 05:25:05.773430+00:00,325,-33
20221W67,2022,2022-04-09 04:50:55.168000,2022-04-09,290,2022-04-09 05:22:51.644800+00:00,322,-32
20221W67,2022,2022-04-10 04:50:19.093333,2022-04-10,290,2022-04-10 05:20:38.030821+00:00,320,-30
20221W67,2022,2022-04-11 04:52:40.536000,2022-04-11,292,2022-04-11 05:18:24.964349+00:00,318,-26
20221W67,2022,2022-04-12 04:56:37.088000,2022-04-12,296,2022-04-12 05:16:12.478629+00:00,316,-20
20221W74,2022,2022-04-09 04:49:22.960000,2022-04-09,289,2022-04-09 05:22:51.644800+00:00,322,-33
20221W74,2022,2022-04-10 04:53:50.688000,2022-04-10,293,2022-04-10 05:20:38.030821+00:00,320,-27
20221W74,2022,2022-04-11 04:51:59.616000,2022-04-11,291,2022-04-11 05:18:24.964349+00:00,318,-27
20221W79,2022,2022-04-10 04:45:06.944000,2022-04-10,285,2022-04-10 05:20:38.030821+00:00,320,-35
20221W79,2022,2022-04-11 04:43:50.264000,2022-04-11,283,2022-04-11 05:18:24.964349+00:00,318,-35
20221W79,2022,2022-04-12 04:52:06.144000,2022-04-12,292,2022-04-12 05:16:12.478629+00:00,316,-24
20221W79,2022,2022-04-13 04:37:11.966667,2022-04-13,277,2022-04-13 05:14:00.607320+00:00,314,-37
20221W79,2022,2022-04-14 04:37:41.205333,2022-04-14,277,2022-04-14 05:11:49.384513+00:00,311,-34
20221W81,2022,2022-04-06 05:01:30.912000,2022-04-06,301,2022-04-06 05:29:35.445039+00:00,329,-28
20221W81,2022,2022-04-07 04:47:15.200000,2022-04-07,287,2022-04-07 05:27:20.384224+00:00,327,-40
20221W81,2022,2022-04-08 04:45:39.576000,2022-04-08,285,2022-04-08 05:25:05.773430+00:00,325,-40
20221W81,2022,2022-04-09 04:44:57.872000,2022-04-09,284,2022-04-09 05:22:51.644800+00:00,322,-38
20221W81,2022,2022-04-12 04:50:27.341333,2022-04-12,290,2022-04-12 05:16:12.478629+00:00,316,-26
20221W81,2022,2022-04-13 04:43:01.824000,2022-04-13,283,2022-04-13 05:14:00.607320+00:00,314,-31
20221W81,2022,2022-04-14 04:33:35.120000,2022-04-14,273,2022-04-14 05:11:49.384513+00:00,311,-38
20221W87,2022,2022-04-04 05:12:57.520000,2022-04-04,312,2022-04-04 05:34:06.789754+00:00,334,-22
20221W87,2022,2022-04-05 05:07:37.692000,2022-04-05,307,2022-04-05 05:31:50.924057+00:00,331,-24
20221W87,2022,2022-04-06 05:02:58.476000,2022-04-06,302,2022-04-06 05:29:35.445039+00:00,329,-27
20221W87,2022,2022-04-07 05:05:06.133333,2022-04-07,305,2022-04-07 05:27:20.384224+00:00,327,-22
20221W87,2022,2022-04-08 04:56:56.832000,2022-04-08,296,2022-04-08 05:25:05.773430+00:00,325,-29
20221W87,2022,2022-04-09 04:53:57.226667,2022-04-09,293,2022-04-09 05:22:51.644800+00:00,322,-29
20221W89,2022,2022-04-09 04:51:07.368000,2022-04-09,291,2022-04-09 05:22:51.644800+00:00,322,-31
20221W89,2022,2022-04-10 04:47:40.480000,2022-04-10,287,2022-04-10 05:20:38.030821+00:00,320,-33
20221W89,2022,2022-04-11 04:48:31.640000,2022-04-11,288,2022-04-11 05:18:24.964349+00:00,318,-30
20221W89,2022,2022-04-12 04:56:50.120000,2022-04-12,296,2022-04-12 05:16:12.478629+00:00,316,-20
20221W89,2022,2022-04-14 04:39:32.916000,2022-04-14,279,2022-04-14 05:11:49.384513+00:00,311,-32
20221W97,2022,2022-04-21 04:35:01.997333,2022-04-21,275,2022-04-21 04:56:51.946833+00:00,296,-21
20221W97,2022,2022-04-22 04:35:25.536000,2022-04-22,275,2022-04-22 04:54:47.197779+00:00,294,-19
20221W97,2022,2022-04-23 04:34:32.128000,2022-04-23,274,2022-04-23 04:52:43.426672+00:00,292,-18
20221W99,2022,2022-04-10 04:50:38.272000,2022-04-10,290,2022-04-10 05:20:38.030821+00:00,320,-30
20221W99,2022,2022-04-11 04:49:41.178000,2022-04-11,289,2022-04-11 05:18:24.964349+00:00,318,-29
20221W99,2022,2022-04-12 04:54:55.533333,2022-04-12,294,2022-04-12 05:16:12.478629+00:00,316,-22
20221W99,2022,2022-04-14 04:38:19.562667,2022-04-14,278,2022-04-14 05:11:49.384513+00:00,311,-33
20221W99,2022,2022-04-16 04:38:08.268000,2022-04-16,278,2022-04-16 05:07:29.023067+00:00,307,-29
20221W99A,2022,2022-04-18 04:29:19.940000,2022-04-18,269,2022-04-18 05:03:11.676458+00:00,303,-34
20221W99A,2022,2022-04-19 04:31:26.826000,2022-04-19,271,2022-04-19 05:01:04.224113+00:00,301,-30
